32 99
36 94
00100100110000000100010001100000001110000000101011001000000110011101010001001001001010001000000001000
10010110110001101000001101000000000010000100101101000110000010100001000010000000011000110111010000100
00001101000001001000010100100010011001100101111100100001100000110011100000010000000000000000111000110
00000010000001001010000010010001010101111010000001000010000000001100000000001000000100100111100100101
01000100000000100011100010001110000110000110100000000110011011000011100100010010101100010101010001010
00000110000111100101110000010000000011110100001000101001010100010010000001001101010100000000100000010
00100110100010010010000010010100000010000011010010000000100110101010000001010000001001010101100011000
10110010001000001100111010110100001100001100011001110010100010100000010000010001100001010001010010000
10000000000000000011001001000110000000000000000010101101010010010000000000010101101000110000001100101
01001100000000011011001000000001001010000100000110000011010100100000000010000010000000100100100100101
11000100000010100000100010111000001000000100010101000010001000000010000100100010001000000110000111000
10000100010010000000000010001111100000010101000100100101011001101000001000000001000000011010010000110
00011011001111100001000111101000000001000000100000011011000000000111010000010101010000110100000000000
00111000100001000100100000100001101011000000110011010000000100100000100000011010001110000001110000100
10000000010000101110111100101001001000100001000001001000000000010000010000101000101000100010010101000
01001001000111010001010100000000010000000000000011000100100011001101010101101100100000000000000011100
10100100000010001010000000001011100000000010010100100001100101000011010000110001000111000100100000000
01001001000000000111001100011101010001110010010001100110100100010010100001000001101101001000000011011
10000100101110011000101000000000100000001000110001000010001010010001010101001000100000000000100000100
00100011000001100010000001000101001000101000001101010000010000000100000000110001001000001101100100000
11010100001100000000001111111000100000011000000100000001000100101010111100101000110001000100000000100
01001110001011000000000100000000010000100100000101010111010001010100101010010111000001000100100000110
10010000000010000010100010000010100001001000001000100100011001011001000101010110000100000001000001010
00010100001101111001001000000110011110010100000000101000000000110110010001000000110001010110010000100
00100100000011010010001000101100001010010001011000000000000010010101111010010111010010010011010101000
10100001101000000011100000100000011010000000110100000101000000011000100000101000100010001001000000000
10100110100000001000000010010001000000100100001101100110000110000000110100000000001001000000010000010
00100000000000001010001100101011000000110110000100000010100010100110010000011110000000000000000111011
10001110010010010010000010000000101110000000100000101001101000101110000100000000100001010000101000001
10001100000010000000100001101000101010000010101100010000001111100000000001010000001000000000100101111
00100010000101000110000011000001100000000000101000101000010000110000011000110100111001110100001000010
00000001001011100100111000000100000101100010100010001000001001100000001000001100101000001111100000001
01010000000010100001000101011001100110010000000110000000010000101000100100000101101010010000001100000
00000101101000001001000100000000000000100100001000100001000000010010100001000001011001000010100000001
00111011000011001000110011000000001010110100100000111000101100110100010010000001101010000101000000010
00110000101011001110000000000001010100000001001001000000101010111010011001000000001010110001100111000
11011000010011100010100010010100001010010011100001101001011000001000101001011010110000010000010000010
10100000010100000100101010000000001001000000001010000000100010010100100100001000001111011000010000100
01000000100100110100000000001000010100111000100000100001000100110001000000100100000100010011000100000
10100101001010001100000000101010001100100110001100010000001010000001100000010110000000100000110001010
00001000000101001100000010100100100011011010000000011100001010101000010101100101000010010001010001001
00000000011110000100100110011001100001000000010000000000000000100000101011000001010000001001101000010
00000100000010100000000000000110010001010110010000000010000000000001000101000110000001000100000000000
00100111000110000101000010000100110010001010000001101110010001011000101010011000010100100010100100011
01100001110111111000010000010101001000000011001110110000011011110110000101010000000110010000001000100
00000001100000101010000001000010000110001000010011011010000000001000100100000010000000101010001001010
00011100000011010000101000110000100001000010100000001101011000011000000001100010111001010101000000000
00001000111000010000000110100001000000110000001010001000000000000100100011000010100100000011001000001
00011000000100100010000000000100000011011110100000101100100001010001000110000000000101000011101010100
00000100000010010000011110000001110000110000001011010010001000010010000001100000000110010000100000100
00000010100100101010101010000100001011101000011000010010011010010010011000000010111010001001100001000
00100000001011110001100011100010000100010000001100001100010100000001011010100000100010000001010010001
00000000000110010111110000011000000000100000100011000000001101110001001010000100000100000010000110100
00010000000010110000010011010000001010000000000101000001111001000100011001100000110000000100001110011
00000000000010100001000011000000001100000001100011111000000011001010000001100110110010001101101010000
10100010110001100000001100010011011000000000100000000011100001011000010110100100110001001000101010110
00100000101100011000000110001010101000010101000010000101000010000000100000001000000000000000001000011
00100000000000010000101010000101011000100001000001011100101000001100001110110001000000100100010100010
11000010001110011000000100010100000111000000000010110001000110100100001001001000000000000010100110100
00000110000000011100111000100100100111000101010100011101010000100010010100100110000000001110001000100
10011110110001100101111110000001000100010000001001010101000100110100100000100100110011000110100010011
00100000110010011110000000001010100000000000111001011100000111011010000001101000110100000000000100100
00000100010000110000011000000001111010010010100100110000010000100000000100010011010010000000100000100
00100001000001011100011010001001000100000111011000010000101000000000110010000000101100111000010010010
01010001011010100100000100010000000100101100000000011101111001010000101011110010010110001000010000000
10000001100000001100010110000110100100101000000001100001000010101000011000010000001000100101000000000
00000110010100000011010100000010000000001011101100100000100110000100011110101110010000100100000001000
00000010000000100000000000100100001010000110010001110001001101000011100000100000110000010100001001001
11011000000001100010100010000001000000000001110000011100000011010000100100000001011010011000000111000
01000010011000101000011110000101000110000000001000110100011111011011000000011110101101111000000001100
10101000000001000110001100100001100011101100010100000011100100100011000110000000000000000101100000101
00101001000010001010000000000010001100000010100011011110000110001000000101001001100001001011000001000
00001001101111100100000101011010001000001010100000000000000110000100110000000001001010001100100110101
00100000001000100110001000000001001010010010000110000101010001000110000100010100000000000011100011100
10100101000010101101100101100010011010000101100110001010000010100000000100100000000100100110100010001
01010000011001000010000000010010000000100010001110110100110000111100100010000110000010011100000000000
00101110000000000100101010100010010110000100000001001000000010011010110101100011000000000000000101100
00101001000000000011010000000000111001100100001000111000100001010011010100001101011001000010001000000
01100010010000100000100101111000001011000011111000001010100000100110110001000010100001000000010000000
01111100100000011011000000001101100100000000001000000000101111001100110101110011110000000010110001000
00001000110001100000111101011000010010000010100010001000101000000000101001000010000000101000001000010
10000010010000000100000110000000000000011101100100001000010100000000000110110011001010111101000001010
00100010010001001000101100110110011000110000001010001001111101100001110000010011100100000000010010100
10001000010101000000100111011101100001001000100000000000100010001001100000100000000011000010001000011
10100000100010000110000010100011010101000000010100000001000101010011100100100110000000001000010000011
00000000011000000000000000000000101000001111000000000001111000100010101011010001000000100010000010000
10001110110001000000000000100110000111000000001000000000001010000000001000000100001000101100000001000
00100101000010100001010000110010111111000110001000100000000000010110010000000000000010100010001010000
10000100000100100101100100001010100000011001101100000000000000101100001110100010000101100000110001000
00000000010110111000000000010110101000000001000000110100100000110001100001001010110000000000001000000
01010010001001010000101000101110101110100010100001101000000000100011000010111100110100001100000000000
01100101010100000010000001011011001000110001010001001010100010000000000101010001100011010010110001001
10111010110101100100011101001000011001101000000000101010000000011101010010100000110000111010100010000
00010110000101010000100111010100100000000001010011010000010000001010001001100010101000000100000110001
01000000110011001000000000010010001001000101010000100100110000000000110000000000100100010101011000000
00001100001100000011000100001010100110001011110101010010010000110001101100000001010111001010001101000
00110001000101010000010010010000011000000100000001100010101000010010001001100000100000000001000100000
01101100110010000000000000100001000011001000000000010000000100001100010101010010001001011101000101101
00100001001010001000101010100100001000000001011110000000101001100001101000000000110100100000000100000
00011000010101111000010000010110000001000000000000101010000000101110011001011110000001100000001000000
01100111000011010000001000011010001110000011000000101000101111001000011010010010000000010011011001001
