55 2
87 71
01000110110000100110011001000000101010100100000001000100001000100100010100000001000010000001011110101
00010010000000000011001010100010001000010001111100111011111000100111101110110110100011011010100000000
00000110000100111000101110000010100010000110100010100100010101000001010000010001100100010110010010001
10100000101000011000101000000011000001111000011000001001011000000010010001000010000100010100010001000
10001101100000000100100001010000010011010010000000100000001100001010110001000011010001001101000000000
10011010011000001001000001000100010100010100000001100000110100101000000010000000000010000000000011100
00000000001101010001100100100000010000000101000001000101010001001000000010000001110010100000011000110
01011000000000100000100000000000001001000000000000001100001000001001000000000010001101100001000001000
11010000000000100000111001010010111111000100000010000000110110010100001010001000001000000001001010001
10000010000101100101001001000000000000110100000110000000001100001001000000000000001110000100010001000
00100101001000000100000000110010000011000001000000001000001100010000001001010011000011001011101100100
01100111000000000000010000101000010001100100000010000000100001101001000101010000010111000001000000001
01100010100101010000000000011000001000000000000110100011001000000000000001000001011001010000000000010
11001110001000100011100010001000100011000000100000000001011001011000001001011110100000010100111100000
01101000110000010001010001011000110000000010001000001000000001000010000010010111010000010000001011000
01000001000110000100010111001101000100011000101010001000110010001100000000100001000000110100011101000
10101010001100001001001000011000010000110010110110011000000100110000010010000001101011100100100100000
10000110111000001000010000000000010011100010100110010000110111001000100010000000000100000000010001010
00100110100010000000100010001100101000000110110010000000100100111000000010100001000100001000000100000
01001011001000100001111001100101010000000000100001000100100000100100010110010100100000000010110000000
00010000010000000100000000100010001000001100000000010000101010100000001000101101001000010001010100001
00000110100010000000000000100010000000001000001001000100000100010101100000000101000010001000000000000
11100010000111011000000000010000000001000100100011100100101100000100000100101101001000001010010000000
00000101001100000100100001010000000000010001000000010011000101010000000101000010001010000000100010000
01001000100010110100000010100011110001100000001010001001110010101100001001000001000101100000110000011
00111011001000000010010000010000010010101000001000011001000000001100000100001000101000111001000000101
00000100000011010001111000001010010100100110000010000000011000010010001000011000000111000110100001011
00110000011010011010101010000010101010011010000100000100010011000011010100110010010000011000100000000
00011100000010000101100010000000001100110100101011001000000101000001001100000100000001010000101010111
00000001000000010100000101000000011100110001000010001000111010000000111100010101010101111000001010000
10111001010000000100001001100101000000100000101011000001000100001010000000010000000010000011001100010
10000101010000110001010000001011010010001000010000100000000100000010000100110101010100010000000011111
00100100011100110100001011101000011000000100100000100101001010001101010001010110000110000000001010001
01100000000010011000000000010100010100000101000000110000101011110000001000010001101001100010000100000
01000000100000010001001110000000010100001010000000000000000000100001010001110000010111000001100001001
10010101100100001001011101100011000001000000010110000100011010111011011100000011101010100100000011000
00000000000001101000000110011000001010000000000010100011010101110101001100001000101101001011011000010
10000100011000001101000100000111100000111100011011101001001011000010000101000000100000000010100000000
11010101110010111000100000110100101101000000000000000110100100000001001000001000001011010010000010000
01000010000000100011000000100101000000110000010001111001000000001010000000010100000010010011001100100
00010010000100000010110100000110100100001000000100000011000100000000010100001010101000010010100110011
00100010001001110010110000000011000010000000000001100011100110101010110000010100000000100100000001110
01000010000010000100010100111000000000010100010000000000010000010011000000001000011010000110010010010
00000001100011111001000011010000101010000011011011000011010110110000001100000111010101001000010000010
01010011000011001000100000000000010100000000100001000001101000000001011000000010001011100010100000100
00101100100001000011100100010010001000100110001000010000001101000100000000001000001010110100000001101
00110100000010111000110001010101001010000001110001001100000110010100000100000001100010000000000110100
11001011000011010100000000100000111101100000010111000100001001000001001010001111000000011000101010101
00001011000000000000100000001000000010000010010100111000000000110010010100000100100000010000000101100
01100010011110000000010000000000110000011011000100000010000000010100011000000011000000010000000111100
10010011000100011000100011001101100100100000000001010010001111110110100000011000010000000101101100110
00000101001111100011101110010000110100100000000100001000001000100010010000001010010000010110000100010
01100010011000100000000001010000011010000000000100100011000010011011001000000011011000100101000001000
01010000100000001011000000010100110001001000000010000010001110000010000000001010100001010010000011101
10100100001010001100000010101001010001010100000010000000111000001000100000000000000100000111100000000
01001010010100000001010001000100001100110011000011000000000101000001010000010000001101000000110010011
01100100001001100000000001100001011100100000001101000111010001001100101001001000001000000101000110110
10100010001010000010000101001001100010110000010010001000010100010010011001010001001001001100000000000
00010000010000000110010100100111100001110100101001000011000000010111100000111100100000001000000000011
00000101001111000000110000000010001100000000000101001101000000000100100000000111000011110100010110101
00000100111011000000110010000110110000100011100010000110001011010001001000001110000110000000010010000
00011010100000000100011001011000000101010100000010011111101000110101000000100001000000001111000100100
00010001000110010111100101110000101000110000000100000001001001000010010010000010011101010000100001010
00100011001101000000001000101010011011000100001000011001000110010001001001001001000010100000010111110
01000000000000100001001100010000000100100011101000000010101001100100000010000010000010001101010110100
00000001100101000001100100110010100000100100000011010001100011111000000000101011000001000100000110011
00000000010100100000000000001100101001000000010001000110010000001001000011000000110100000001010001000
11101001010010110010001010000110101010100000101010101000000001001000110100010000001011011000001001000
10011010101000010110001100111101110100100001110100100000010001100101000001000011001100001001001101110
10101011110000000010010001001000000000011100000001000100000001001000100000101011000000000010000000100
11010000000111001000010001000000000100000100110110011001001010010010100011001101000010100000110001101
00110111011100110010000111011010001000010100001001000001000000100001101000100011000001000010000010011
01001110111000000110110111000010010010110100001000000010100000000000000011000000010000100000101001100
01100010000101011111001000010011110000000001000010000001001001000000000010001001000001000101010110001
11000100000010100000100101000001100100000001000011000000000100001000010010110101011110011001001110000
00001010010010010001001101101101000000110010010110000101010110001100000000010001000100100000111000101
00000100100100001000110010000111000111101000000011000000010000110011101000000000000011000101011001100
00111010011010000000000000010000101101100101101000011000000111000010100000000000000011000000010000000
00000001000101100111000010011010010000010100010100000000111110010111001001000101000000101100100000001
00010000000100001001010100111000011001001100001010100100000001000101110000001110000000000100000101000
10010010000100101000110000000010100010000000001000010000111010100011101010110001001011000000001000111
01011000001110100101000001100000001000000011001011001100000001000000000010011010011011000101001000101
01000110100010010110000000000100011000111001000000100010011100010000110010101011001100000011001100000
00001000111000001001101110000010001001010000010000100100010000000000000000010001000100000100011000000
10010000110001000101010010010101000100000000100100101010001000100000001110010010000001110100001011000
01001110000101001011000000010000000000101101101110000010000100001000001010010000101101000100000010001
10000011101010010001010000100000011000100100000001001100001111000110100000101001101000100000000000000
11100000001101001000000011011000000001100101001000100100110010000100011010110001000000000100000010101
00000010001001111110001110100000000100101000000011001010001010001001100000101010000001000001000000000
00000000010000000001000000001010000011000100000010000100000101001101111001000001100000110000110000010
00000011101000111000100000110100010001000010101101101101000000000001000000110010010000000010110001010
11000010000000000100000010110010110010000110011000000000000001000101111101000001010001100000110000010
01100000001010001010000110100000001001000000010100010011110101000101000000001110000000111000000010110
00011001100000000000010100000100001000101001000000110100110010000100011011010100010110000000100010000
00110010000110010000001000000100000010010100000010000000000000101000000101000000000100010001100101010
11010010110010000001000000001000011010110000001000010000100000011010000001000000110001000100010100000
11100101100110110010110011000001010011000101110100000000001000000010000000001101000001110001000001011
00101000100011000100001100010110010001001101100000001110100010000010000101001000010011010010100100111
10100000001000100000000100110001010010001010000110101001001000000000100010010010010010100010000011000
01010100011110000000010100000000010011000011000011000110100101000111000000000000100111001011110001000
10000010000000000001000011110100000010100011010100100000011000000001000010010100000000000000001000001
