56 17
86 60
00001100001101010010000010000010001010010101001000001010010000010010110110000100001000000000001100000
00110000000000100001000011100000110000100100000000011100001001000100000000000011100100001100011010011
01000001100000000000000000000101001000110000000101000100100000000000000000110001010000000100001101100
00110101000001000001000000100000011010010100001101001000100000001000100110000000100100001000000001100
11000000000010100001110101001010000100101101011000110000100000000010000101001000001011100000001000010
01010110010100100010100000000001011110000101011000000001001000011100010000010000000000011010010100001
10101010110000000000010000000001101011000100010010100110101100000100000110010000000011000000011000001
00000000010100001100000000010000000011001101000110010011000000001000000000000110100110000000010101000
00001000100010111010010111100100100100010100100010010010010000011110000000101011010110101000100000001
10000011001001000000000000100000110100110100001010000000011100010010000001000100001000010000010101000
01011010000000000010000001011000000000101010001000010100011001000100000000100001100000000000000000000
00011000011100011000000111001110000110100000011001100010010000100000000111100000000010000001101000100
00100000110001000010100110001001101000010100010110001001001000011001011011010001000110010100100010100
00100000101101100001000001010011010010000110000000100001000011101000010101011011001011110000010001100
11000010010000100100100010011000101001011000001000010000100101110111000001110010000010001000000000000
01000001100000101010111000010000101111000001000000100000110000000110100000101000000001011000100100001
00000001010011001000100110001100001000010100010000000010010010010100100100101101001010010001001000100
00001010100100000000110000110001000001100100000010000010101000001010000000000101000110000100010001000
00110000000000000010011000010100000010000001000010001010000100010101010100010001000001100000011000011
01011001101000000000100010010001100010101001000001111010000000101010000110110000011010001000000010000
00010000010100000001100010000000000000110100001101001000001100011110001000011000000101000010100111000
00000111000010011000111000000000001011000000100001011000001100010000001000100000010000000001110000000
00000100010000010100011010111101100000001010001000010000111001110000010010100000101000100000011001000
10111011001010000001011010001010101101000011000110110010010000010110111110110110001000010000010000010
01010000001000101101000000010010011010101001101100010000000011010100000000000000110101010000011101100
00000000100000101010000010000100000000000010010001000100010010000000101111000110000101000000000000000
10000010110000111110101010000010000000000100000000001101100000000010001001100000000100001010011111000
01000000100000010000000000001001101100001000000000100010100000001000001010000101001000100000101011001
10110001010000001000110000100101010010010100000000001100000001000011100100011101100011001100110100100
00100100000111010000010001100000000100001010000000000000100001000110000110011001001000001001001101100
11100010100001100000000110110110000000000000000010100111000000100000001000001110011100000010100000000
00001100000100101000111001001000010001001101010111000101101111000000010101011010000000010000101011100
00110000000000000100000001001010000000010001000001011000001001101000011000100110000100011000000001000
00010100100001000011000010001001101000010111000010011010011000100001010100001110001000010010000100010
00100010010000011000101100110100101100110010010100000000010111000000010000010001011000000001001000010
00100100010100001010000110000000000101000010010110100010010001000100100100010001000000100100010010000
00010000010000110000001000010100000001110100010000010000001111000100000100100001011001010001001100001
00100000110100000000001000001001000001000010000001000000000010100110000000000001011001000010100011000
00011011000100010011001010000000000010010010101000100010010011000100100000000000100000001001001010010
00000000011011000000000000000000000000000000001001000010000000100000001001100100000011011000000101001
10000100111000000010000110000000001000000101101010100110111101001010000001001000000000101001000010000
10010010000011001100000000000010000000000011101101000000101011000011000101001100101100101000000100110
01101001001010100001000100010010001010001000111011000000000110010000000000000010010010000001011000001
01000000110000101000001010000000000011000001000001001110010001110110010001011110010000000100111000000
00101100000001000010000011111100001100010101001111000000010100000010110011000000010001010000000001000
00000000110011001011000100000000010000101101001010010100010001000100000000000010001110000100001000001
00010110001100100011010000000011000011011000000001001001001010010001101010110010110111011000100011010
01000001000001000000000000100010000010000001001101000001000111001000110010000001010000000000000100101
10000001001111100011000000011110101011001000100010100100100100000000000001000100000101000000110010000
10000010000100010100000110000000001100100111100011000100010100010001001000010100111010000001100000110
00100001010000100100111000101000000010000000000001000100000000000101010000000000000010000001101100000
00001101000000011001101001110001001000010110011010011000010001100000000001000010111101011010011010001
11000010000110010000010010000010101001000000010100011100000101010100100001010000000000000011001110001
10000100000101001001000000100001011000001010001010000001000100010010000010111100001001010010000010001
01001000010000001010100010001000001000100011000000000001000010100010000000000100000101000010100011000
01000010000010100000000000001001000101001101000000000000100101010011000111100000000001001001010000000
00010001000100010000100100100001110101000000010000010000110001101110100000000000000100000111001111011
00000110100000010001000000100000111100000001000001101000000000000101101011100010000010101000011000000
01000000110000000000010001000101100111011000010011010010000000000011000000000010100000100100000000000
10110001010001000100011000000001000000101101110010011010100010000000100000101000010001010100000000100
10100010001110000010000110011111000101101010010000001000000100010000010010101010000110111001001101000
00010111000010100000100010000100010000000100100000000100010000100111011000001000101010000111000100101
00001101000010110101000000010000000001001101001101001011000001100100000000000110000100000111010001000
01001100000010011010100001100010000001100011001100000001001110101000101100001000100001000001001001000
00000000001010100010001010110000011000000100001011001100100110100001110010000100000000010100000010000
00000010000000001000011001000111000000000010011101000000011001011100010011010111010100100000000000000
00110000100010000101000100100010000000000010000100101100100000011000001000001011001001100000000110101
00110000010010000010000001100000110010010100000000000010001100000001001011000001001000110111010001011
10011000001101110000000000001100110000000000100000000110000000001000000010001001111000000000101001000
00010101001000010000000000000000111000111100101000000000000000000001000001101000100010100000100100000
00000110100011010000000011000110100001000110011010011100000110001001101010000010011000010100100001010
00000001110000100110000000010101000011001001000000100010000110101000000110001000101000100000010000110
00000000001010000110000000010011110000000000100000100001000000111010111000000000100010111110100100001
01001000000100001000100010001000000000100000000011011100110110000110011001101001001010000000101010010
01101000000000000011100111100000001000000011100000111000011010000010000100101101001100100010001101000
00000000001100011100000000001010110001010010000100000100101010111010011100000111110100011101101000001
00110001101000001000001101000010000010101010101010000010000001001010001000000000000110000001001011010
10100000101001001011000000000100000100110011000010111001010000111000110000101010000000000000100010001
10110000100100000001000000010101000010110100111100010100001100100101000100000001100000010000000000000
10101100001001010100000010001000001010100001000100000101010001010001010000000001110001111100000000000
00011000000101000001001011011001101000000000000010101011000000010100100000100110011000100000001110000
01100000000000101100010101101000010000111100100000001000100000001100111010011010001010101011010000110
10110000011100100000010010100101000001001111001001000000010010000000110000010100110111010100100000000
00100000000100110001110001000101000011100000011000110000010000111101100010100010000000001010000100000
01101001110110010000011101010100101000100000000001010001011010101110000011100101000000000010000000000
10010101001010000110000010110000000010110100010000000001011000100001000000000101100110000010110110000
01101010110100110100000010011000111001000001101010010011001100100010000010100000000000000001001110001
10100000000110010000000001000000000100000000010001000010000100000000000011001110000100000100001000000
01000001001001000111000000000010100011001000101100010010110010001001100100000011000100001000100110111
11000000100010000110000000000010011101100001000100000110000110000011000100000001001010101011101100010
00100011000001000010101100000001110000000001110100100100000000000011011110000000001001000010100001010
00101000001111010000001001000000011010011010010000010000000011001000011000100001100010000110001100001
00000000100101011000010100101010001010000000000101000100101100010010001100001001100110101010000000101
00000010010110110000101000010000000001110100001000001001000100010100000000000000000010010001000010101
00101001110000001101110100000000000100111101100101000000001010011101010010000111000010100001001001001
10010000000000000011001000000000110000000000101011000001001001010000011010000001010111100100000000000
10000000000000000101100110011100000100000000011100000000101100001111000011000000000000000010000000101
10011110000101010100000101001010000010000000010000010001000000000011010000100000000100000000100110100
00011110000000100001111010001000100100001100000001011000101001010101010001001010100100001100101000000
01010011100000001011000101010010001000100100100100000000000001000001000010001000010100011111001000010
10000011010000010000100110001110010101000000101100110101000000100000101001001100010000110000001100001
