61 39
99 5
00100001001000001000010000000001000101000001001110101010100000100010000101010000010011000100011000000
10001101110100000110010101000011000001000010000000100000000011100000001000010110010100101000000000011
01010000001000010000000010010001111010000010011010101010000000011000000000000100010001110011001000000
10101000100010111000000001011000000000100001010010100000000100000000001000010010001010001010110100000
10000100010001000000001000000010100001000000000000010000100011011010110001000011010010110001001000011
01001000000000000001001001001000100010001011001000000000100000010100010000010101011110000100100111011
11000101000001101000000000000110110010100001010100100111101101011011101010000100010001001001100001000
10000100010001001000110100100000100000000001001110011101001000001000000110010000000000010000000011010
00100100010010010010011101000000000001100000001000100100010010000010000001010000000010011000000000000
00000001100100000010100000001001011001011010000101010011000001100101110010010101000000000000111010100
11011100101001100010000011000001000110011000010000101001000000001001100000001100100001100000100100010
00100000000000000100010010101011000110000000001100000010000000000001110000001001000100010000010000000
00101000000100101010000010000111001001000000100000010000010010100100001001000100001110001010000001010
10000001100001100100011100011001110110000101001000010000001000101010010100000000001001110000100010000
00011000001001000000001101101010000000100110000000000000000001000100000000010011000110001100000000010
10110101010000000000001000011000000011010000100001000000010001110101010110100110110001000100110000101
10000010010001101011010101010001010100000101001000110000000100000000101011000000011001011100011000000
00100100000000011011101010100110100000011001000010111000000000010000011001000010101010000010000001000
01111010000101110000000001010000101000001100110000000101001001001110011000000100111011000000100001000
10010110101010101000001101000011001100001100110000000000010001101010111101001011010000000000111100001
01000000100000101111000000001101100000000000000101010100001010110100000001000100100011010010000100101
10000000001001000010101001000001111010000001010010100000011000000011000001001000111010000010000000010
00100000110000100010000011011000000000010000110100100110000010101010000011001100000000100110000001001
00000000001001000100110011001000010000100100001000000001000100100001010100100100000010011010111100010
01001100000010001011000000010010100001001001100011001000000000001100100100001011000000110000100010010
00100101000010111001000010110010110001001101010010100010000111001010110001100101010000000000000000111
00001000000000100110000100000000001000001010100000010110001100000010000001110001000000000101001100000
01101001011010011000101000000010010110100001011001010101101000000000000100000110111101100101000010101
00000110001100000000000100110001010000100001111011010000000001100000010001001000000000110101100010000
00010000000000011000001000110001011010100001000000010001110101101101001100110010000000000100100100001
01000000000000100101010000000000110010001100000100010000001000001101111001110100100001000010001001001
00001100100100010101100001110011000001000000100000001101000001000000000001001010000010000000111000100
00001000100000000101000111010000110100000000011000000110100000010110011000000011100001000001001101100
10100001000000000001000100000100001000000000011001000010100010101100000101010000001001010010111000101
01100000001011000000010101001000000011000001111010001100100000001100111000010101100011001111000000100
00000000111000000000100000100010100110001001101100101000001100001110100010000010100001001000001100010
00000000101100001001100000001001000000101110001100000110110011100010001101001000000000100100100101110
10001001000110100100000000000100111001100000000110000110100001011101001010110100100100011100101000100
01010001001011000000000000011000110100100000000011110100000001101010110000100001000001000000001000100
00100010010000101010001010001110000001000101100100100001110000001000000011010101001000010100000000101
10000100000001100100101000100001101101001110000010000000000000100101010000101110010100010000110001110
01101100011010111100000101001001000000000000000110101100000010000011001100110000100001011100001110001
01001100000010010100001000000101000000000110000100000011110000011100100110000000101111001001001011000
11001001110101010000100100000001110010010000100001000001100001101011000000001100101010000000000000000
11110010000011010011100001001000101001100101001000000100110000000011100000100100101111000001110101001
00001100000000110000000000100000101001010100000101010000101010000100000000000010001000000111000101000
01000000000000100100011000000010100000001000100010010101000010011000100110001010000001100000001000000
10100100100011000000001000010100110111000110000001011011011111001010001010110000000110000000000100011
01000100000010101100000101010000000000001010101000000000000000110001110100001001010000000000100010110
00010000110000000000000001010010000000000101000010100000100000011101000001000110000010000000000100000
01011011010000101000100100001010100000010101001011000100000001000000000001000011000010000011001100000
01010000100010010010110001010001000000001010100000100000011110011000010011011100010100000000011011010
01000110000001001100011100000001011001100000111001010100000000100100000101001000110000101000001000001
00011010000000000001100000101000001000001010010110000110011001000001000000000100100111000000001100010
01000000101010000000100000011010100000000100001101010001001010000110000000100000101101111000010000010
01000000010010000111100000100001010011000111110000110001010100100000010010001101011000000110010000001
01000110101101000000000000100000001101100000100101100110000000001100101001010010000010001000000000000
10001110111000101011001000000100001010100110000000011100001100010000000101000100011000001000110010110
00110001001100011001000100010000001101100010001101100111100101010111111100111000000100000101100000001
10101000000100011011001000100010000101001011000000000011000110011100001001000010011100000101010000110
00011010100000010000111100000001001001010010011010001001001001000111000001000100000000000000010010001
00000011001100000000000000000001000010100010110000001000000010000001101000000001000000101100010001000
00101100010000001000001001010000000001001100001011001001010100110000000010001000001000101000010100011
00000000010110001010000111010001001000001010000000000110000100100010000110100100100000010001011100010
01000101001000000010100000010000010001011001000010000010100100000000001000110100001101110100110010001
10111000000000110000001001011101100100100001001010001010100100010000100100010010101000000010100100010
00111100000100000100100110000111000000010000101100000110000110100001100100100001000100000000101001100
00000000100000101100111100000000100000011100000010011001011001110010011100001000001000011111000010000
01001000101000000100000100000000100001000000001110100110010101000001000000001001010001010100000011100
00000101001001100000000100000011011100000110001100000011001100000000000011100000001010001011110001001
01000100001000100000010000110001001000001000101000010010000010010010001101000000000100110011001101000
10000010010001001100000001001000000000110000001100000010010100000110101100101010010011000001110000010
01100000100010010000000000010001101000010111000000010010000010000000000000010000000010000000101100001
00010010000000000100010001100000000000000000001010000011011000000001100001100110011101000001011000101
00000110000000000000001110010010000000000001001100100110100000100000000000000001100010000100000010000
01010011111001011001010000000001000010010000010010100000010000001110000110111000110111011000001100000
00101100010100001000100000000001001000001010111000001011000011010001011010011000000000000010010100010
00010010001000101000101100001000000010101111001001000110010001000100101100010011100100001100010001010
10000001011000010100010001110011011000111000110100110000100101100000010000000101000101000000000010000
00000011000011011010100000100100111010000011010010010101010000001010100101010000010000000100000000000
00000011000100000111001110100000000110100011001010100101000100000000000100100100000000001000010001010
01001011001100000100111001000100000000011001110000000100000001000001010111001000100100000010000010100
11101000001001100100000000101100001000000000010111000000010101001110101101100000010000000100100000001
00011000010010001000110101010011011010101100100000100100011001010010111101000000010000000000000000000
00101011111011101000100010100101010000000000011000111000010010010000100000010100010110000001111011000
00101000000010010000000001010000000100010001100000001101000000010010010010000110001001001000010110000
10010001010010010010100100000001110000100010000111000010000001000000000001000110000101110110000101000
01100000011000000000100110000101010010000000100000000010000000101110011001001101010000010101000001111
10001110000000010100010101001010000000000000100100000000000100000001010001000111000101010101011000110
10000100110000000010000000010100000000011100000000000000010010001100101010110000001010000100011000000
10011001000000000110010000000000100000000000011001001101010011000010000101100000100110100000010001000
10000111111100101010111110010010100100011000010000011011100011000010000000000100100101000100010001011
00001000010100101100001000110000010001101000010000000100001011000000100001000100111010100100001110100
00011101000010110001110011101010001001000000101100100001000000000000000010001110000100010100000100001
00100000000000101000001010000000001000000100010000101000010000110010000000001001011000000000010100000
00010100000010000010110010100001000101000100000110110110010001000000101100100001100001010011001010001
00011100101000101110100000000100000100001100111001101010101000000000000110000111000000001110001000000
01101100011001010010010010101000001011110100110101011010001001001000110001000000011100110000000101000
10000000000000000011000101000000110000000110111110000110000001000010010000000000000001010001000000000
10011000010000110000100110100001000100000000000010101100000000100010000000110000001100000101010010000
00100010010010110001001100100000010000000110011011010100010000101000011000000001100000001000010010010
