34 53
67 24
00100000001011001100001010110000100100000101000101101101101000001010000000010010001001100100100010000
00000000011000000100110100101000000000000001000100010010010100010000001110000000010110000010000101001
01011000001100000011001000111000101010010010001001110000010000100110000001100000010000111000011010000
01000001101100000001101000001010100100101101100111101111010000000011100010000100000000001110000101100
10010010011010001110000110000010110011000011101100000001001100010010000000000101000000000001001110000
01000000010001000001110011000001001000010000111011000001010001001011100000001000011100000100010000000
10010100100110000010001000111000000000010001010001101001010000000101110101001000000010100000000001100
00010001000100001110111100000001111000100010110000010011001010110000010000001000100010110001000001001
00010010000010001000000110000010010110000010100110001000000000011100000011110000000111011101111100010
00001110000001000100110010000011010001000100000010001000010001110000100010001111001100000001010110010
01010001000001000100101010011010110101000000000000111001001110110101000011111101000100001010100000000
01000100100000001101000000011000001001000000011000000000101100001111110100010101000011100000000011010
00101000000000000010000101001000010111100001010010001000001011001010000000010100100001111101000000000
00100000100000100000101001101110010000010000100000000111110100100000001000001100010000010010001010000
01110000010011010001100000101011011110100000010010001001000000000001100101000100100100001000000000000
10010010000101000000000000010000000100011011110000100100001111100000001101000111000010000001000010001
10101000101000100001011000000000010101100001011010111000000101000110010000110110010001000001011000010
01000000000001010010101000000010100100000000000101010000000000000001011000001101000000001000110100000
00000101001100000010101001000011010010010001001001000000001101110000010100000111010100100000100100110
11000001010111010001000000001101110100100101101100100110000100000011100000000001000000111000010100000
00001110001000000100000001100101000000011100010100000101001001010000010001001010000111110000000010000
00100000100011101100010100010010101100110010100010000100100000011000000010110001000001001000001111000
01100100000000100100111100010000010011010010000000001000001101100000001001000000000110100010010000100
00100000110010000000101000100001001000100100000100001010010010100010110000100010010011101000000000000
00001110001000010111110000000100101000000000000010000001000000001100000000010010001001110000000001011
00110000001000110100001101000101100000000000001000100000010110000100000010010010100100000000000000111
00010010000011110101000100000000001100100000000100100000101000110001000111000101100000000000010100000
01011100000100010111000000010101000000101101000100100000110010000001100000100110010001001100000010000
01111100001000100001010010001100000001010010000100001001001001100000000001001000110000000110011000010
00000101000100011001000000101010000110100000000000101001100000010010101000000010000000000110001000101
01000001000001100010100000000111011000000000011000101000011000000011000101111000011100000001001101010
10010000001011000000111100010001000110000110100110000010110100001000101100101100000111100001111010000
00101100111010000001100010110010011000001100010000000000010100000000001100000100000100000000100100001
00000010110011111000011100101000100110100000000100001100000100000100000001101011110000101101001000000
10101001100010000000000001010100111110001000001000001011110111100101000000000001100000000011100101010
01111000100101001100101000000010100001100000100000010000000000101010001010011000000100001000000001010
01001000000001001010111111000101000010100010100001000110010000000100001000011100000010100000000111010
01001001101100001000000001010101100000100010010100010010000010101111000111000100111010000000000100011
01101010100000000010010101000000010000010001000000000111010001000001000110101100000000010001101010001
10100000001000000000000010000000001000110000000011000000001001001100000100001010010010000001001010000
00100100101011000100000110010001010100001000010000000010001010110010011100010100000000010000100101000
00000001100110100011000010001000010000110100001100100000001000010100011001000000000001111000000000110
00000101111001001100000001000110000010100101010010001001000000000000011010001001100111001100001010000
00100000001000000000001010110000010010111100100010000000010001111000000110000000000010100001100011111
00100000010110101010000000000001000001001000001010000001001000111100011000000100100100100001010001000
00100001001000001101010000000110110001000000000000001111000110100000000101000000000010110001000011001
00001000011000110010001001111000100100001010001000101000101001000000010100111001001001000110111000010
10110101000001011010100000011100100001000010100000000001011000001100100100100010001110010100000101011
00001010000000010011011000000001001101001001000100010010000000010110000000001101000010000000000000010
00000000001100001011101110010011000001001101101110001101100100011001010000001001110000010010010010000
01100100001000000000000100010001110011001001000010000000111100000000010000000101000000000001000000100
00100000011011010000100100010000000100100010010000000110000010000100000101010100110100011000000100000
00001000000000000010000010011001100101100001000000000001000000010010000000000100000000101011000101110
00010001000110000100101010010010100000000100101000110001000100010000110110000000000000000100011010000
00100101101000000110100101001000110001010000000001100000011110001000101010100000001010000000001000000
00000110010101001000001110000001000000000000100100011000000011100010000100111101100000000001001101110
00100101000001000011101001100100011001100100000000000011001000000001110010000010101101101101000101001
00100100001110000000100100000000001001100001011000000010010000000101001000010001000011010001010010100
01000111100111000001001000000010000000001001011000100000000000000001100100000100010111001001100101100
10100000000000000001000000000001000001001110100000001001010000001000011001010010000101010000010001000
01001001110010100010000101000001011001000101100010100111100001001011000010000000110001001111000100000
00000001010110001000000101001000000101010001000000010000000011000000000100110011000000000000010010100
10001001000000101101010011001010110000000011000001100000100011010000000011001000010001100010001011001
01000010000101001110000000100000000010000010100000100001000111000000100110000100000010110111000000100
10000001101001110000101111100001010000000000010010010110000000011100000010011010010010000100110100000
00101111010100100111001001001000000101010100010100010000000000100000110000000000101001110001000010000
00001010000000000001000000100100011100000000100000110011010000001000000100100111000100010100010101000
00111001000000001010010101001000100000001000010110011000110100100000100010101000001100010101001010000
10000001110000000110000000001010101000010010000101100100000111000001000100010000010000100000011100000
10010001111010000101010100000100110000010000100010000000000100001000111001000001000010001101100101110
10000101000000000100100000000000001000100011101010000000000100000000001001000001100000000101001000001
00001000000100100011111010000011001010100010101110010011000000011000100010101010000000001010010000010
10000010101001001011001100100000010101100000100001000010001000011000010000001001000101100011001100001
11101000001110000100010011001000001000100010110011000100100010011100100101001010101000010001010001001
00100100111000101010101100000001000100000010000000001000100011000100011000000010000000000100100100000
10001011101100011000000001010010100100100101001000000111010010000010001011000001100010000000100001010
10000101110000000010011100000101000001100000001010010110100010111000101000011000001011000001001001100
00110001001001101100000100000000011000000001010101000101001100000000110101001010000101000110001001010
01110000101010001011010100001001000001000110000000011011000101000000111100100100111000001000000111100
01001000000000101010101110000000101001100110000010000000000000000010000000010000100100010100000000011
01010010111100000110011010010100000001100100100100010000100000100010000011110000010110100000000010000
01001000010000000011001100100000010100101000001100001101010010101010000010011101001001001001101000000
11100100101101001000000001010000100000010000101100100001101000100100000110001011001000100110000101000
00100000011011001000100101101000001111000010110110110001100000100100010010010011100100001110100001000
00100000001001001000111000010011010101000011100010100001000100010010010010000100011000000010011000000
00100100111001101000100000000110011110010001000111000000101000010011000010010100001000011001100010000
00000110010110100000101101010111000000110000101000010010001110010000000011101100100100010000100101001
10010000001001000100010010001000000101000000000000100001000010000101001101010000000001010001000011000
10010110001111100001000001000010001000011001000110011001101010000001010101000000000010000000001001000
00110000010100000100001000101001000000100011000000100110100011000001000100001100000010110110000001001
00101001111100001010000000000000011000101001011000010000000010010010111000000001010110110000000000000
00001000100110001100000101100010000010000000001100010010010000010010100011001000000101000000100000000
01100010000101000010001001001011000000101001110000000100010000100000000100110101100001111001001010001
00100101011011000000000000000000000011010000110000101011001101000001001000000001100101000100100100010
00101110100011010000010000000001000001010101010010001000000010000000000111110000010000010000001000000
00000001010100110001100000101100000001100010100000100000110011011011010010100100001110101111000001101
11010000100100000000000110110010100010100110110011001100000010000000000000010100001010100000000101101
01000100010001000000001101100000000000010000100011001100000000000000110010101100000000100110001100000
00000000000010001000000011000001000000110000001000110100001100101010011010001100111010011011000111100
00001010000011000000000000100000010001110001000001000000010001000111010001011100001100110000000001011
00001010001010101000100000001100011100001010101010000000010010010001101001000100110010000100000000010
