46 44
98 59
10001010010000001000000011100001000000100000000000001001000110000001000110111010000010011010011010100
00101000100000110001010010000100000010000000001000011010000000001100000001001000011000000101101101100
00100010000110101000110010000000010001000000010000100011000011010110100001100000000100100011010001000
10000100010010000100101110000010100000100001100011100110011010001000000010100000001010000000000000010
00000100001010000000110000000010100110000100100011001010010010100000100010000100110100000000000001001
01011000010001000010000000000010100001010111100010011001010100010100100101000000010101101000010100101
00010011000000011110000000110100101000100010000010010000100011110100000010100001101010000001000101001
00001001000000001011000000001100000010000000000110000000100000000010000100001000010000100000110000111
00110000000010100001110101110010001010100000000011100100010100100101000000100000001000000000110011000
10001011000011101101000000000000001001000100011000100110000010101010001110001000000000010110000010010
00001111000000110000110110000001000111000001100001100000000000000000100010001101100001011010100011010
00010000011001000000100000000100010100110100000010011111000001001000000100000010101111100010000000100
01011000011010100000101000010001000111100011010010000110000000101001010000000000000110010000001001001
00001000000101101100010100000001100001010000100101000000001110000010001010111011011000001010011000000
00000100100000000010001001011000001000000011010001000100010100000010000000000010000010101000110001000
00001001111100100000010000001001111001000000010000110000000000000000100101100001110100010100000110010
00100010010000001101000100001000010010000000000001000111011000010001010000010010100000100101010010001
01010000000101000011000000000101000001100001100101000011000010000001101001000010111001100000001100101
00101001000000001001100010011011010100001110000001000010010111100000011000011111000100011000110000000
11001100001010000110000000000000011010000010001000000110000000100000100000000000000000100001010011000
01000010001010000100010111011100010000011010010101010000001100010001000100000010100000000001000010101
00110000000000010000100001000100000001000010011001100000010010101000001000100000000011000010101000010
01000101000001101000000101100011111010010001000101001100000000001000001011100111110000100110000011001
10001000000000011001000000010000001000000000000010000110010000000001001000101111010110100011011010000
00010000101111110100000000100000010110001000100010010001110001000101000000000001110000000000001000100
00001001000010100111100000010010010101000111011010101000001000110000000101100011101000000101100100100
10000000100100000001000010000011011101010101000110000000001010100011001101001000010010000001000100100
00000000100011101100101010001100000010101011001000000100000010110001010100010000011100000000001001010
00100000000010110111001100001100100000110111010000100000000101000001000100010010000001000101001000110
00000001001000000000111000100000100000001100010101010010000000011000000011000000010010110000000011100
10100101100000010111000000000100010010100001010100101010110010001001000010100100000001000110010100000
11000011000000100100001110000001001001000000001000100100100000100001000011000100011010100001000100001
01000001001010010001010000100100001010101000000010000101010001011010001011000010000001100001010001000
00010101000011000010101111000011000101000000000100110000011001000000000101000010010000000110000001000
01000100001010110010100011101000111010010010010001010101100110000110001111111000000001100000000001010
00100001100000000000000000100101000011110000000100100010001010100001000000011010000100100111000011000
00110110000000010000001000010101001000010100010100010100010100001010000000101101001100000000000100001
00010000110000001010001110001010010110001001010000000101000000000100000001101010100000000000001011000
00100000000000000000000010100000000000000000111000000000001110000000111000001000001011000000010000000
10010000011100000001000001011001111100000000100000000010010100001001001001100110101100000010100000000
10010000110100110000100100100110010010011101101010010010111000000010001101010000101100101100111110001
10010110101001000000100101011001100010100100001000010000000000110000000101000110000100110100011000011
01100001100100111100011001000000000011000001100001000000100010100001001101010010000100100000000100000
01000011000100010000000001101000110010000000011000000100010100010010001100000101111010010000011100010
10101100001000001001000000010000010001011001000100000101101000100100110100000100010000101000010001010
10101000110101001110000011100000001100001101000001000010000000001110111100000010000010011000000001100
10000001100000001100010100010101000000000010010011000000000111000000101010010001001010100010111101110
10000110101000000000000010000000000000010001010010000010000100110000000101010000010000001000000100001
00000011000000001010000000010011000010000110000000000000010000100010010000110000100100000000000100000
00000000001100010100000011110001010000000000101011011010011100000001101101001000001001111000000000001
10000001111010001110010000010110101000001010000000100100100001001001001100010000001000000000000000000
10010001010011010010000101000110000100000100000010000000000000001011000001110001101001010101000111010
10000110100000000100000000010000110111000001010010110001011100000101100011000001000111100100000011000
00000000000010100011010000000001010000000001001001010111001000001010000000001110000000010101011001100
00100100010111000100010000100001100000010000011100010011000010100100000100010001000010100100101001010
01101010000001100000001100010000100010100011000000000100100011010000001001001010001100000100010110100
11011100000001010000000000010110111011011100101001001010010101010001110000001000010010001100010010000
01110101010000100001000100011010000000100010100001000010010000100100000110101111011010111011010000000
01010110101000000010000000010001000000010110010000000010100110101010110000000100010110000000000010100
10000000000001000110000010010001000010001011000000010100000010100100001100100110000000110000010000100
01000010100001100100110010000010010100100001100001000100010000011000000101011001000010000100100101100
00000001001100000001010010001100001000000100001000011000001000100100001000000000101000010100001011000
01001010000100001101000000000100010000100101001011001000001000000100010101000111101001000000001000100
01100001101010100000101000001000001110100100000000000100000000110001011100110110010010000001101000101
00010010111010010000101000100000000001111001100000000000000010010000000001100111011001000000010011001
11100011000001100000001101100101100001001000110000000000100000001000000000000101100000010000100101000
00100010000100010100100001100000010010111000101010000000100000000000000010011101000001100001100010000
01010000001001000000101001000111001100110000100100000011100001001100000010001000001100110011001011100
00100100101000010001010000101100010100100010000000000001111000000000001100000000000110110001010010100
01110000101100000010101000001100011000000000001000001010000110010001000001000001100100100000010100101
01010101100001000011010000000000100000000000100100000001000001010010110001000100001001010101100010000
10000010110001000001000000000000101010010010000000000001101001010100000010001000101100100000000011000
00100011000010011000100000101000101100001110000001100100010011001100101000000000110000000100010100000
00000000100100010011000000000011101100010000100000110110010101010100110011000000101100011100010100110
00010101001101000000100010000001100000101010000001110010100001010111001100000010100101000010001000000
01100010001000000000010000100001010011000001110001001001000010001000000010000010110011001010000000000
00010011110000100000001000100001001000000001101100000000110101010100000000110100001000001000000111011
00011000100000010010010001010001001000000011010111000011001000000011100000100010000110110000100010000
00010011001000001000100000000000000110000001001000001000010101010000100000010000111000000010000100010
01010100101100110100100100000000100110010111010100000111011001010001001000000000000010001000100001010
00001000001000101000000010110000100000001100001100100000100011000000101011000000111000010000010000010
00001000000000111010010010010011011000000100111001010001000110000010010000001000010001100010000110010
00001100011000000010000000010101000011101100010000111000000000100000010000000100000100111001101010101
00000100000111011001000001001000110010100000001000000000011010110110000010101100100110100000010000110
01000101010110100000011011010010011000011000100000000100001000100100001000000101001000000000001000000
00011000110100000110000101101000000101000000000101000000110001001100000000101000111010101101101100000
00000100001100011001000101100010001001000101100111010000000001110010000000000000001010001101000000000
00010100001000100101100000000111001100000000010000000100101000000001000010100111100010101010101000000
00000010101110101000110100000101000000101011100000101011001001011000010001100110101101101101010000000
00000111101101000100001000000001101100001000111010000100110101010001001000100000110110100011000000001
01001000010011010000000000000000011000000011100000000010000000001101000000000101100000000101011001010
00000001010100010000010001100011100011000001001100010100000000100000100100000110000000001011010010110
00011000000000001010010101011000100100000010100100100010000000010000000110000010100010110011010000000
10000110000000000010010000010000110011010001100001000000000000010101001101001000011100011000010000110
00100000000100000000100110000010010001000100100101001101111000010000000100100000000000100010000000110
01101010000100010010110011001000010011000000110000111010000000010000000000010011000010100000011011001
10100000011100000100100100000111010110100010000010000000101010001001000110100010000010000011010010000
01010100000001110000001001100000000000000100001000100100100010110001100000101000000010010000001000000
01000000000000001010100100101010001000000010000000011000100000010010010100000111001101100000000100000
00010011010100000000010000001011000010011000000000110010001001100100001100000100000000000000010000000
10001010110010000000000101000001101000010000110010001010000100100100000101100110000010010000000010010
