4 17
66 17
00010010001011000000000000000000001100110100000000000000000000010100100000000110010001000000000100101
01011000100100000000011111101010010011010111000001101100001001101011100000000000000110001000010001000
10100111010000010010101100110001000001000000000100001100000011000100011010000001010001010100000100000
10001110101001100011100100010001010100111001000010000001101001001001000010110000110001001000000000000
00010001011111110010000010100001000000000010110010000000000100010000110000000000000000001001001010101
00000010100000001001111010000001000000011100010000100001000011000000110001110011000000111000001000100
01100100110001000111011100001000000110010010100000000100101000000001000000000101001100110000101101000
10100000100001000000000000010000010100000001001000000101100100000110001000000000010010001101101000001
10000101000100000110110001100100000000000110010001010100010000000001011100101000101000000001001010101
01010000000100001100000000100001000000001000110101011010111000101001000100000001101100010000010001110
10100001000111101100010000000001010101100101011011000000000000101000010100001110011100101000010000000
01101101110101010100100000101000010010101001000000011001001010000100010000101111010000100001011000000
01000000011000000100101011000101100011110010010000000101110011000000000010001001000000100001011001011
00000111100100001000000000101000011100010101101010000001001110000000100000001100000100100000100010100
10011000011101001010001101001000100010000110000011100010100101010000000110011010000101010111010100111
10100101010101100000011000010111100010100001101010010000001011010001000101000010000011011001111001010
01001100101110000100110010000000001000001110001000001011000000110000000000000010010110000000001000001
01001000110000100110000100101001010010100000000101000001010110010001010010010000000011100000000010100
00000001000000001000100000010110101010101000000100010000000010101101010110000010000001001000000001000
11110101000011011100010000000100011111001000000100110001010000110000100000001111000011110001010010000
00011010001100000110001000010000000000000100000100000010011100001001000011010000000000000001000000001
00010110000001000011000111010111001100010100001010101100001011001000100011011001100100000001101100001
01001001101010011001001000000010111001000001110001001001101000000000000111100010000001001100000100001
11000100100001000001000110010101001111000000111010000000001010000000000000111001001001010000000001000
01000111000000000000011000010001100000000000000010001000101100001001110000000100110001000100011100000
01001000000100000000011110010110101000100000110100100000001001001011010000010100011100000110010000010
11000000000000100111110000010011011000010000000000011001100111010001000101100000010001100110000000010
00101000010110000100000000100001110000001000000000011000000010000000110000000011000000000010000010100
00000110100000010000110000010100111110000000111001011000001001001000110101001010100001000000001000000
01001011001111011000000001000000000000101000001000100010110000010000000000100100100100001001101100110
00010001001010000000000000110000001000000000110000000000001000000101000101010000000001001001001000000
00101000000101010000100010000001010100000110000000001010100000011001001000110000101001000000100001100
00101001001001010111000000111100101010000001011001100000000001101000010100100110000100111000000010100
00000000111000001000010010000010000011010000100000000100010001100001101111110001100100100010011111110
10101000000011001001001100101010000000010001100100001101010001110000000000001000001000000000000000000
01011000001000000110000100001100010001000010100010000001001001000010000001000101000101100001110010000
10110001010100010010010000001010100110011000000000100000000100011101001100000010010001010010010000001
00000000100001000010001001000000000000000010100000000111010010000000111001111101000010000000100000110
01101111100001011001011000000110100011000000000000100100000010101000000100000011101110000100001000011
01000011010100011000000001000000010000100000000000001000001010010010001100111000110011100011011110100
01101100001001110000110000001001010011000111000000101010011010000101101100110100001000001010100000100
10100000011010100100001100100000000100011011000010000100000000000010001100001001100001100011010001001
10010110100101000001000000000100101111000001000000010000010001100000010010001011100110000000101100100
00000011110010010010000100000000100000101000010100101010110001001000000010101110000100001110001001110
00001011000001000001010001000101010000001011101010100000000010011010000101010101001001000000110001000
00110000000010100001100000100000001000000000000000010001100000000000101000110001000000100010111110100
00000000010011110111010100101001000101001100011010000010000110010011001100100001000001000100100000001
00000000010000001000100000000000001000000111010001000000000000010101100001011001001101000000101000100
00001100000101100100110101000010010111100110000111101000010010010001011010011110100010100000000010101
01101000000000000000000000010011000001000000001100000100000010100011000000110000010100000100101101000
01000000000000000100000000001101100100000000111001001000000011101000000000000001000011001100001001101
10000001010111000111010000101000011100001000100010100001101010011100010001010001000010000000000101010
10000000100100000101101000010101000000010110000000010000000110010010110100010100100010000000010000001
00000001001010000100001110000000110000001010000001000000000010000100110000000000010011001011100011000
00111000110000001101000010011100000100000010011010010001001001000011000000001010000111101100010001100
01010101000000101110110101010000000000000000000011100000000100001010011000000010101000001101001001100
00001100100010000001100010010000100000011001001010101000000110110010010000000000110011010111100011100
11000000011000000100011100001100111000010100000100001000011001010000010110010010000000101000000000110
10100001000010000010111100010000010001001001000000100001000110000011010011100000010000110110100000010
00100100000001001010000100000011101000100000000001001000010000001000000010000010000001010101000110011
00110000001011000101000000000100110001001000001001000001000000001100000001010000001100010001011101011
00111000001010000010000000010001100000000010100000011000111000100100100110001011010011001000011000000
00000011000110100011010100100100011001100010110110110010000010101100000010000000000100000100101000110
00000100110000000000100101110000001100000100001100001010000000010001001101100001110000000100111010000
00000011000100010000000000000111100100001001000011010100010000110011000000000100001111011000001000000
01000001011000101100100110101010001101011000010100110000000100001110101100000000000010110010000111010
00000001001001010000001100001010000000010010000010110010001011000101001010000000110000100000001010110
11001000100011001100001000001000000000101101001001000010000101000010000010101001000001000000000000011
01010100000000010100100100100010010100100010000001010010000010000100000110101010000000000000010010000
00001000100000000000010000011001000010100000000000100001000100001000010010001000010000100000000110001
00010010111011010010000010000011000100000000000000100010100000010000000101000010101000000000100000010
00101010100010000011000100000000001011000101000100001001011100110000110100111010010110001000000100000
11100001101101000000110010000000100001011001110101001010011000000000011010101000000000001001000000100
10000110111011001001000000110101000100011010010101000000001000000110110110110001011000001001100010001
01001011010000000011011011000100100000001010100000000000010100000100100011100011101000000000000100010
10011010001011100010010010000100101001011000100101010001000100100000101110010000001011010010000000100
10100000110110110110000101010000010000101001010111110010010000000100000100100100111000011101010110100
10100100010010100110000100001001000000100110100100001001000101100000010001100010000000001010101100001
00101001000000000110100110011110010000010011010110010000101000001000110100000100000010101000100110101
10101000100000010001100101000001011000010000000101010011010000000000001000011111000001001000100110000
11001010001011000001101001011001000010000000100000010011010001011000001110010000101000010000111010101
00001100000001011010010101100010000100001000000010000101000100000000010000100000000100000000010011000
00100010010010110100001001010001010000000001101011100001000000100010010001010000110000000100000101100
01001000000000001011000101000100001000000000001011011011000001000000001000010000011001010000000110000
01001000000000010010111000100001100110000010000000110110000000110100000110000100001100001000001101000
10001000001000000101010010001000011100100010000100000000000000000100100001000010000010000101000010011
10011000010101010000001100100001000011000000111101000000111000100000000101010000100100111100000010100
00101001010101100101000001001001000000110010000101001001100010000010011100010010000110010000000010010
00101000000001000110101011000100001001010110010000000000000010101000001101000011000001001101111100110
10001000000110011001000000001101000100000100100100001000001000001010000101101000000000010010000100001
00000000000000000000101000000010000101010100000101111000100000000011000001100001001101000010011100100
00000001011000000010100100100001100000000000000000100101010010001000001001011011010101000000110100000
01000001000000000100000101010000010000010000001001101110011111101000001000100010111000000010110100001
01101000101101001010110101000001010000101010010100000000000000001000000000011100001001001101000010000
01001100001000000001101001010110011101101100011100011000101000010100000101000000000001100100001010000
00110010100010001100001001110000001100000010100000000100010000000011000010001100010110001100010101001
01100010001000000000010000000000100011010100001000000000100001001001000010011010001010100001111000010
11000101000011000001001010000110001100000100000000000001001000001110010011000000100001000000000010000
11100000010011000000101010010101100000010010010000100010110011100000001000010001010001000011001010000
00011010100111000000011001000011000010101100110000001000010010000001000100001000100110000000001000100
10110000010001000000010000010000100100110000000001000011001000000100011000101101100100100000010000110
