2 71
100 30
01000101000010000011000011010000100100000010101110000000000001010000000000001010001000000000001001100
00000000110100100000000110000101011011100100001001100000001001100011010010001001100100000010010000000
01000000011010000100000100000100010001101000010001000110010100101000000000001000000000000110001101110
01101001001100100110001101011000101000001110100001000000110000110010001100110001010001100000010101100
10101000000000000000000010100001000001000000011100010100000000110011110100101110000000100010100001010
01100000010001100001000100000010000010100001001000101000011001000101110010000101110010001010000001001
00001000111001000001100011001100000000010110000000010000000101010111000000000101000001001001000010000
10000110000100000110101000001000001100000001111000000010100100110010100000001000000101000010000101000
11000100101100100000001000011000100100000000001010000100010100000010001010001010000011001011101010001
01101000000101010000100010000000000001100001111000100101001000000111000000001000110101100010101000011
00000000000111000000011110000001100000011011001001100010000111010000101000010011110001000101001000100
00000001001001001100000000000001000000000010000001100010000100111100110000010101001001000011010010100
00100001000010010010100111000000000100001010000000011101001100000010011000010000000011001000010101101
01110000010000100010000010000000010000000011001011001010001000000000100000000010000000110011101010100
00001000011000011000101000000100001001000100000000100000110011000000100000001010000001100010010011111
10101001100001000101010000001001011000100000100000010110000000100000010000000000000000010000100010000
10011100000001111000011010000000001010110111000111011001000000011100100000000000000100100000000111000
00010000001010010100000001001010001000001010000000010001110010010101000000001000011001011011101100000
00110010100000010000000000001000010011011010000000000000000000100010100001100111011010101000001100100
10000101110010010100110100011000000000110001001010001001010111110000010000001110010000100110000001000
00101010000000001001010100101001110011000000010100000100010010000010011001001001010001001100000010000
01011100101100000100000000011001110010000101011000001000011010010000011000000000000000100100000000101
01000000111000011010001000101100000100000011110001000001000000011000010010011000001000100101001000010
01010101000010000000001000010001010011000000100010000010000000010010000010000001000110000001100000010
00011100000000100100010001100000000000101010000000100000000110000110000110000101110001000101110100001
00100001011000011000001001000000110011000110000000000100000000000011000100000001000100000000000000110
10010011000010000110000010010100110011111000001011010101010001000000100111110110010010000000000010010
00010110100000000000000110000100011000000101011000101100010000000010001010010011001001010001010000000
10000110001000011101000000010010000100010010000011010010110010000101001001100100000100001100100111011
10000000000000100100000000100010100000100100101100001000000100100000000001000000101111100110100000100
00010110000010100000100100111001110000011001000000001001001010000010000000000100101000000010010100110
11000110000000110000011001100100001110000111000100000001010100000100000011100000010011000000101000011
10110111000010011000000100010000001000100001000110110110001100100110001110001000000010001000000000000
01000101000010011010100001001010000000001001010010000001010001000010000000001111000010000100100010001
10100000100110100000001101000100001010101010101000010110000000110001101001011010000001000100011001000
00011001010000000000010010001000000010000000000000000101001001100001000000000100110100001000001100001
00000110010000000011100001000010000110000000100110010000110101010100000000000011001100000010000100000
00000101100000000000000000010001000000001010000000100000000000000100100101000100100001010000000011111
00111000000101000010000111000100000010110000000011000010001000000011001000010110000000010001000100001
00000000000111000000100000100000100011001010100010010101000100001010010000100000001000010011101100000
01000011010001001000000010111000100001001010110110011000010011000000100001110000000000100010001100010
00000010000000110000000000000010001000100011010100000100000110000100101100010001000000101100101001000
10100101010000011000001000011100000101100000001000000000010101110101000100000100100101000000000000001
01000010001001000000011001111001100100000010000010010010001011000010001010010000000010011010101000000
01000011000001001110000010000000000001000110000001100000000000000001010111011001110000000100000000000
10011001001101100010010001001000100110100000110010010010100000001100100000110001001000010011100000001
00001000010010100000010100100000001000101011000000010001011010010101010100001000000100000010000100010
01001001000010000100010010101001110100000001101000100010110010100100000100101111100111000101100001000
00000001101101010000011000101010000001000001100110011001001000110011000010000000111100001010000010000
11101100001000100000010101100110011010100100010000000001010011010000000001101001001010001110000000000
00100011110100000110101000010100001000100000000010010000100001000000000100000000101001100010000110010
00000001000000010101010110010010101110100000010010100000011001001000000100011010000111000000100000000
01000010000010000110011100011001001000100000000100101101000001100000001101100000000000100100010000100
00110010000100000000001011000000001001100010000100011001010000001100000000011001110010011001100000100
00001001001011100001001000100011000100100001001100000010111110101000110001110000101000000100000101001
01000010100101100100011000000001000010000101000000110000000010000010000000100000110101001000001010100
11100001100100100000010111000000011000000100010000001111000100101001000100000010100001000101010101000
10010001010011000000000000000000100110110010010000001100101000000111001011010000000000100101010010100
00010001100100001001000010001100000000000000000011000010100100000000000010000000000010001000001100100
00000000011110000000000000000000100010010010000100100100000001100010100001100000100000110010010000000
00000001000010000100100100100000000010000000000000000000000010000000110101010000001000100110011010101
00010010100010010110000001011100100100001001000100011000001000000100011100000111010001011101010000010
00001110101101100000001101100000000000000011001100000011010000101000000011100100000000111010000000010
01110001011000111010010000000000100001000001100000001000100101011010010001000000000110000000011100110
11010100000000100010101010010100011101100100000000001100110001010111110000001000101000000001000010001
01110010100000011000100011000000010110000000010110001110000001100100100101010000101000000001110110001
00010010000100100001100000101110101000100010010101000000011000100001000000110010001001000001110101000
00000100011100000000010000000000101000100100000111100000100100100100000001001110010100100100001101011
11100000000000000100001000010010000000000010000000101000000001111010000010110000101000010010000110001
00000100010000100010110001000000000011000011010001100000100110000100000110000101010111000001101100000
00000000000101000001101000000110000001111100110010100010101001000000100000100000001110111000000000000
00000000000001100000001011011010000010001011100010011000001000110101100001010010001001001000000000001
00100100000110000000000101100001100011001000010010101010000010101000000011001100001010000101111000001
00001001011011101000000000010000010000000000001000000110000001111000001100000001100010000001000100010
01000110101000010100001100010010000001011000100000000000101000000110001101010011001000010000100001101
00010100010010011000000110000001101110100000000101011010000000100000010100000110000011000000110100001
01000100100010010010010100010000000100001000000100000101000100110011000010010010000000000110010011010
01000101000110010010110001000001010011001001001000001101000000100001001000000010100001010011000000001
01000110011101100100101000001001010001000010000000100101001110000101011010111101000000001000000010001
00100101110100100101101010010010100001010000100000000000000000000010010000000010001010000100010000110
11001000000101000000000000000000000001010001010100100001001001001000001101010000000010100000000001000
01111000110101100010000000000000000001000000111000000001001000011010000110001000000001101100000000000
00000100000010011010101000001001001110000011000010001000001110000000100010010000100100001000010010000
00100100000100100000111000000001000011000100100010000001100110001011000000100000001000011101000000000
01000001001101000000000110011000000000000100101000000100010100000001000000001000000000000100000011110
01000010100000100010011100101000100110001010101000111100010010100101000010001010110101011010010000000
00010110000000000000000011000000101000001001010001010000001010000001010001001001011001100010010010000
00000000010010000110000000011001000100000010000001010000000011000001001000000001100010111110000100110
01110000000000000000000100010101000000110000000010100101001010010001110001110100101000000010011010010
01001001000010100000101000001010001000000000000001010010100000000000100000100100000010001100010111001
10000000001001101100011000100001000101000111100010010000000101110000001101000100111000100110000000010
01000100001000100001100001001010001000001000110000000000000001000000000010100100000010010001000110000
01010101001001010010100000110000000000100000011001000010000000010000000000000001010000101001011000010
10000100010010100111000111001000011000000000000000100100001000000000000001000001010000011100101001101
01000000100001110100001100011010010001111010000100000001001111000110000000000001101100000001000001000
00000101000011001101100001010010110001001001101011101001100000010000000010001000000000001000010000111
01000100000100100110101110100000000000010000001101011110010010100001001010010101010000000110011000100
01000100000010010000000001010111000000010001010111010101101000000010000001001010001000010101001100101
00000100000001110110001010001100000010011011100111000000100000001000010000011000001101100110100000001
00000001010000000100000011010000000000010000101000101000101110011000110110000010100100100110000101001
01110000100010000000011011010000000101101000010100001000011000010100011100000001000101011000000010110
