99 55
23 80
10011000000100000100101011010010001010110101000110000011100010000000010110000011000101010100000011000
00100101000100110000000011001010001101110010010000111000010000110000100000100001010010000101000101100
00000011000001000100011000100101010010000001001001110100001011010110000000010000000000110010101000100
00000000001000101010001000100000010011011000000010010001001100001100011100000100000000001100110100010
11010011010000100100010100000010001000010000010100011100010100000010001110001001000001100101010011000
00010100001001010000100011000001000001100010101000001011000000100110110000100110010000010001000000110
01010010000000001000000011001000000101000010000000010100010101001100000011011001000000001100010000100
00001000100110000110000100001110000010000010100011011000000000010100100011000101101001100101010000011
10100000010000100000001000011010011000001000110110010110000011100100100000110000010010001100010001100
00000011001101110110010110011011001010000110010011001100000100010000001010010000011010001010101000010
00010010010011001100001011001001001010011001000011000111101010001101001001110010000000110111001000010
01101101000110010000000010001011100100000101101100110100000010100001010000000011100010010000101010001
00001000001000010010110101100100000010000010000001000001001101000111001011000000010000000100000001100
01100010100010101000101001001100000010101000000010000000100010100110111001010001110000100000010010000
01101010100000010000000100001011010010000001100100010100001001010001010111001000010001010000000000100
10100011000000000100010001000000011100010110000010000010100001100010000010110000101000110100000001000
00111101100010110000000110100000100001000110100100100110010000100000000100001100101100010100001001000
00010000001000000000000000100000010001000000000001011100010000000011000110000101000000001010110000010
01000010000001000111001000011001100110010110110010000010011010001101011010010000010001000000101100000
10000000000010010000010000000110000000000000010000000010100000000011000000100111100000000000100101010
10000000001100010000100101000100101110000011100100111010110010010000000001010110101100011100111001000
00000000100101110010101101100000000000101010000011010010001010001000000001110110100001010000000000000
11010001100000000010000011100000100000010100010000100001001000011000110001011101000100000010000001001
00000001100100000001010000000010100000100110100011001100000000000100110010101000010001000000100100010
01010010111000001110000000100000001101101010000000000011001011010011101100001010100000000001100000100
00001101000101010100000010010001010000000001000001000010000001101001100101000110100010000000111010001
01010001010001000011110000100100010001000111000100000000000000010000000000000010100000010100011000000
00111010010000010000100000000010110100100000101100010000110010010000000000110001000010110100000001101
10100000011100010000000000000000001010011100101100100000100001001101111000010000111011000001010010000
01000000101001010100110011010101000111001000110000101100110001111100010000011000000010000000000000010
10010010111011001110101010010100000100100000001000001000010100000010100000110100011101010010000010011
00000100100111000000001100010010001001101011111100011100001010111100011100001010001001000101001000010
01000000001000100100000001000010000000110001000010100010000100000000001000100000110001000000100101001
10001101110011110000100000000100010011111000101000101000000001001000100010010101000100000111000010001
00011101110000000100000110000011100000000000100000000100000000110101101111000100110000000010011001000
10100010001000000100010001001000000101000001010010100001010000100000110101000101011001000000010010110
00011000001011100010000101000100000000101011000100010000001100010101011100100000001001010000100000001
01011100000001000001010100101100011000101011001100010001101010101001100101000000011000000000111000000
01100000010110000000101011110110100010100111000001000010010100110100001010110001000010010010000010010
00000101000011000110110000000011000100110000100100000100011011010100011000000010100101011000011101100
00010001000000100110000100011000100001010110000100010010000001010010100001000100110000001000000000010
00000100000001000000000000001000110000110111011100100111001001101100001110100111110000001000000000010
00101100000100011010100001100010010110001000000011000000001100101011000101010000010000110000000010110
01010100000111000010000110001000010001010100110001000100011001100100000010101000010110001001110000000
10100100010000001000001111000100000000111001010010000101000110011001000001010000101000100010000001001
10010100110101000000111000110100001010001010001010100100011011010010110000010100110000100000010000000
00001000001010100001100000100110000001000001010000100101101000000100000000010100101100101101010011000
00000000100101000000101001010001000001000010000001010001000000100110000010001101000110100100000101101
00000010101100000000000000100110000010001000000000000010000000001100010010000001011100000000001100101
10000000001101001010000010100001000010001000010000001010000011001000000010000000000010000001100000100
10101000000011000101010000000100000100010000010110001000100000000000110001001000100000010000010001000
00010100000101001000001000000000000001010110010001000100100001100010010000011000110101000000010000001
01100101100001100001001010000001000001000101010100010000001000100000110000000001010000111000110000100
00001001010010100001000010010010010001110010010100001010000000000010100000001000100101000010110011010
11111101010101100000001001000011010000000101001000000000010101000100000000000001101011110010011000000
00000000000000111001010001001101010100001001110010010000000000100000001000110100000000101000010011000
00010010000010000000111010100000000010010011001000011010011100001101000010100110000000000101101010000
00000100001000001100000011000000000100000101100000000101010100100011010000000010000010000001011110010
01000010010100001100000101011100111010000100100110001000001000001000001010100110000100000000000000100
00000000000000101100010100000101100011000101100001000000010100110001110010101010100100100111000000000
00101000000000101010011000011010011100100101010001001000001001010000110010010000100110010010110001000
00100101100010000000100101010000100100000000000010001000000100001100001010101101011000001011000110000
00000001000001000100011001001101000000000110100101001000000100110101100000001010000100001100010100001
00100001000001100010001001000010100000000011110001001001010010101001010011011001010111010110000110001
00001100100000001000100011110000000100110100000001000100100010001011000101000100100000000100001101000
00000111000001001010011000000101000100100010000010011000110110010001000001001010001000001001110010110
10000110001001001010010000010000000000000001011000010000100000001000000000001100001000010110000111000
00001100010000000110000110100110011010110011110001110000001000101000100000000101001001000110110000000
00000010010000010100001011000100000000100110110000000100000000001001011000000000011011100000010100101
01011000000010000010010101100000000100100010000010010000010001010000010100100000000100000000010000010
01001011001000011000010000001100000101010010000100000000001100000111001000000011010001100000101010101
10010001110001010000101010010001101000001001000100000110000001001001000000000000010000010010010000000
10000001100011010000001011101100100100001010000001101000100000000000000010000001000000011000100100010
00010001111010011111010101000000000001000010101010010001000000110010100010000101100000110101000001100
01101110000000110011001000001110100100001001000001000101000010000000000100100010111000000000101110000
01100010001011000000000000001011010000001100000001001110101011101000000010001001100000011011001101011
10101000000000011111101000000000001111011000001010100010000001010100000000000101110011101000100101100
00000110000000100100100000110000000010100000000000000011100010000010000000111001000000010110000101100
01110010010000000001110011110010001110010000110010010001100000000100001101000000100011000100100100010
00100001100001101101000100000111001101001000011100000000001000100000100100000100000101000010101010000
01001000011010001000010001000000110101000000010000001001000100000100100011000001010000000010000000011
11101100001000000000111000110010110100010000100100000010000011001000000000011110100000011001010000100
10000110000010000010001000000110101010001000001100010100110110000001001000101001010000000010010001011
11000010100100000010100101011001111011000010010000001000000101101000111011000100001000011000000110000
01010000001000100000010101011000001010011001001011010011010000000000100001000100000110100100110000000
00000000000100011110001001000011001000010011000000001010000000000001100010010000011100011101010000010
11010000000001001000000011111100000000011000100100001001001110100000010100000100011001011001001100100
00000010000000001000000000010000001110100000110101100000010000000000000101011000000100000000100011100
10010000110110000000000110100001000001010000000001000000000110110101100010000010011000100000011000000
10000000100000110100000010000100011010010000010100000001100010100000000100110110000110100000100000000
10001110000010100000101000101000011011100010000100010010101011011000010110000110000010100110100110000
10100000010010000001001001101100010100100101101010010001001100000000100111011110100100010010100001010
00101101010000010000001110000001000100100110101000110101100101000001000000000000000001000010000101000
11000000000001011000100110000001000110000000000101011000000011000111000100001001111011000000110010000
10011000100101001011001010011111000011111100000010100000010000001000000010000100101000011100100110111
00010110110101001100101000000000010100000011010101111000000100000011010000011110000010100000001100101
01100010001000001011001010001010101010001000001101010100100000001010010011000000101101000000000001000
01010010001001000110100000010010101000010011000001011110001011001111000001001100000010001100010001010
01100110010100000010000000000000110000001011010100010000100001011001001011000010000001001000100000000
00000000000110010100100100110000000000010010001100000100000001101000010001010000100000010010001110100
00010101000000010010000010000100101010010100000010011000100000001100000000011010110010100000100000100
