68 64
1 86
01000100001110000101001000100100000001100010000001101101001000001010000000000000011000001000000100100
00010000001000000010100010100000100100000100000000100000110000100110110000110100000001000000100100111
01100000000010110100100010011100010100000111100000001100010100001001000111100100101000111110111100100
00000000101101001000101110001000000001000010001100000010001011100000000001000000100000001000010010010
10101000010000110001100000000001000000100101100010100101100011100000100000100010000101010001110001100
00000110000000010101101100000001100000010101100010000100011000101011001000101101000000000000000000010
10011001010001010011000101000100001100100000000010000011010000100000010011100101000101000000100010000
10001110101001000110000100001000100000010011000000101000011010000010010101101100100100000101000000100
10000100011000110110000010100010000001011101000110001000011010001001110000000100110000001001101000110
00001000010100000000000011001001001010001010001010000000000000010001001010110000010000000010000010000
01001000000100000101001001000010010000000000100010010010000010010010000100011110000010011100000110001
10110000000000110100100011011010001011000010000101000100010000000010000000101000111111100011111011100
01111011010000010000010000000000100000100001000100110000100000011000001011001100010001001110000000010
10000001101000000101001000000000101001010100000000110001101101000110011010100000010100000001000010100
10010000110111001000100000000101001000100000010010010110100111010000100001000010001000001100010011101
10010111000010000011100100101000100100000010100000100100001011000110001000000111000001110100000010110
01111110000000000010100111000001100000000100000010100011111110000000001010010000011110101101110010100
00000010000010110010001010000000110000000011000000000101110000010001100010101100000010010000010010100
00001011100110001000000101100100100101001001011111100010000101001111001000001001010001000001101101001
11010001001011010000001110100001010010001110000100000000010100100101001000010100000010000001101011111
01111000000010100101101010101000010011110010100000001001011000010010110001000100011110000011110000100
00000000000100010000011000100000000010001100101000000001100001100000001100000010001001000000000000000
10000010000000000001001100100001011000100100111000010010001000001000100011100000010110001000000001000
00010001000100000110100000000101011010000001100100110001000000000010100000000001010100001000110000111
10101000110010000000110101000110010001010010000010111011000010000101000000101010010010010000110000000
00000010000001000000000110110100000010001111000000001010000101010000100000100101010100100010100111010
00101010010100001010110100000011000101110100000010010000000100100001000001100100000110101000001000000
01100110010000100100010110011000000010000000010010000110000001000001010011001010100010111110001100110
00000000100110000010000000001010000111100010010000000110101110000011100010100000000001000100110000100
01010100100000000000000000010100000000000010110000101100000100000000000010000100011000110000110010000
00100001010001001100000010010000011000000001010010000011010000001110100000010011000101100001000100010
10001000110000001000000100010000100001000101001011101101100110000010000000001001000110000001010000001
00011001100000110111011000000000000100110000011100010000010000011010000001010000000010011001000101001
01101000100010100001001101010010001101010000100001000000000010010000000001010100000010010010000000000
10001110100000011000001110000100000010110010000000010000000000000111000100000001000100000101000100001
10110000000011100000000000000001001000110000000010010101100000001000100111100011010001000011001000010
00000001011001000000010010000101001000000000110011000010000111001000100100010100000000110000000000110
10101001000000000001101110110000000000000010000100000000000010101100011100101100000001000000000000010
00000100111001100001010101011100010010001000011111001010001000001001100110000000011011100000100000000
11000000000000011000100010011010011010100000000001001001000000010010010001000000011000011010011100000
11010000000000100101110100100000110100001100100100100001000001010000010001000001000010110000100010110
01000101000100111100000000011001100001010001000011010011111011000010110110001010000100001010000011100
01110001001100100000000010001000001101010000011100111010010010010000011101100101100010010000001001100
00110000100010100001010001010110000001100110001000001110000010000001000011001000011000001000011000111
00100011110000000001001001011000000010001010011000101000101001000000001000000010000001000000001000000
00111010001000000100000000000110100010010001100001010000100100010000100000010000100000000111000100010
01010101001010000001100100001000100110011000000001010110010000010100000001110000101011100000101000011
00011011000001011010000010100010001110010000000100001100000001000110000000001110101000100000100100010
00000000010000100000001010000011010000000001000000000010010010001000000010000100000000010000010000000
10000001000001011000001011000100100000100011011110100000000010000001000001101010000000000010010101000
10001011001001000101000001000010101000100000000001000010000000110010000100100101001001101001110100000
00100010000000001001100000101000010110101000110100010100100010000100010100000010000101010101000010010
00001000100000000010110000001001001111010001000000010010010000100000000100011100000000011100011000000
10010010001000000000001000010100000000100101010011000000110000001000101110011000101110011001000000010
10100000111000100000000000100000000110100011010000000100101111011000110010000000000000001000000000010
00010000000010010010000010001001111000000000000100000011011000100010010111000000100000010010000100010
00100010010001000101010010111010001010011000000000010011000010000001001000011000100000100000100000000
10100010100011110111010001010010000011000110101001100010100011100101000010000001101000001001100000001
01001010000000000000000110100001010000111001100001010000101100001001111001001010000000110000000001000
10100101101001000010100001000111000110000111001000001000101101101000101001010000100001010010101101000
01000000100110000000101000000010000000000000000111001100000000011000010000010010000110110000101000100
00100000010000010000000001101000011000000000001000100000101110010100010000110001000011010101010000000
00001001110000101000000100000000010000000100101011001101010101100101000000000110001001000010101010001
00100111000000000010010000100000101001100010101100000001000110101000000101000101110111000101010000010
00000010110000101011010001100000000111011010110001000101010001010101000100100001010100101001010110000
00000001001010000100000000000100000000000010111010100000000011011110100000010000000010101001000101010
01100110110010000000000110001000000100000100101100010100000100000001100110000000001110111000110010010
11010010001001101100100001010101010100000101000000001000100100110100011100100001001100000100100000000
10000010100100010011001010000110100101000000010100110001000000100001000100001000001011010011100111101
01001000000000000101000000000000001000000110010010100101111000000111000011010110100100101001000000100
11000110000001000100100011000011000010010100000001000000011010000110000010001100100000000110001000011
00111010001100010000101000011101101000000100010001000001001010010100110100000010001011101001001000100
00000000011000000101100000010011110010100100110100010110000000101101001100101010100001010100000010010
00110010000100000011000000000100001001010001101001001000010001110000110011011001001000110010000100110
00001101000100000000000100010100110000000000010000000010011000000010110000000101010000100100000010101
00110001000000000000001000000010000010001010111000000000100001000011101000001100011011001000101100001
00010100000001100110000100000100000000000010000000001001010010000000101000000000000100001000110000011
11101000000100100001010000001011000101010000010001000001100000110001000000000111000001110000001001000
11010000010000000100010000100100000110100000110001000011000000110000001000000100111110100001011100000
00100000000000101001100111000110000001000000100000001001110001001000000010000101110001000000010100011
00010010000001010101000111010010000011000000000000010000010101010010010010100001000100100000101001000
10001000000010010111100000100000000011101000001010011000000001100001100011110100000001000011010000001
00000000001001101000000001011111101100010000001001101100010011000011000110001001100001000110100010001
01110000100100000011111000110111101001000001000000011010100100000000100110000001000100100101000110100
01010110000001000000000000000000100000110000100110110101101101000110000101000001100101100010000000000
10010011110010010111001011010000000000000000001000000110011010000010000010100000000000100000100100100
11110000000101100101011000111000000100100010100000101000110001000001000001100000001100100000000110100
00010000000010110000000000101000100100010001001100110100000000101000101001000010000100000000001101111
10000000100011110010001001001100000110100000000100010000000100110001001010001010011100000100010101010
00101100010000000011100000000000000011000010100010010010100010101100100010000010100100000000101011011
00001000000001110000000010100001001000010000110100011000001100010000000111001000000101001000000100001
10000001000000001110000100011001000001001000010011100010010110100010001100100000100000000000000000010
00010010010000100000000100001000100000001011000100000010000100100000100001100110100110000011001001000
00000001110110001000111100101110100101010000000110101100001010100001000000000010101010100001001010000
00010000010001110111001010101100100000000000000101011100001001000100010000100110000101101000001000110
01000100000010110000100011001100000010000001101011110000001000010100010100010000000000000011100100110
00000100101011011000000000010000001110000000010000010000001011000000101000101011010101001000100000000
00110000000000100100010100010001001000011000001000000001000000001000010100011000000110000000011010000
01000010001001011000100110100011011000100000000000001000000011000000100100101100010000000000100100000
00000110001100000100110010011110011010110000010000001000000000000001001000000001010001100011111000011
10010000101000000000000000100010010000001000100010101010110100010001000101001000101000011010000000001
