32 36
2 12
00001010100100110000000100001100011010000000001000111000001000010110001011000000000010001010001101010
11000000010001000000101001010000100000010110100000000010101001100000011100000000010011000011101010101
00000001000100100010110000001100010001000100010100111101101011000100000100100000100000001101010000010
00000010000000100110001000101001000000000000110100001010110000000010101000000000000010000011000000000
00100000100010010111000011000000000101010011000011000110000000000001101001100000010000111011000000000
10100000011000100000000000110000000001110100110110000001100000101000110000111000000001000000000010000
00000011011000100100000100100100000000001001001010000000000000100100110000100001000001011000000110100
00000101011110111000010010000111101001101000100101000000000010010100101101000100000000010000010101000
10101000100100000000010010000000000001001000000110011000000001110010000000100010101000011100001011000
01000010010000000000011000000000100001001001011010010010000111000011000000110110011000011100000110000
10011000010010000000110011000100000100101101000010011000010011011100010000000110000101100100101001000
00100100101100011011001011000111000000101000000000000000100000010111001010101010010010010000100101000
00000011100100100010000000000100001001000100100100001000010001010011000000000000001011100010100101111
00011001000000001001000000011010000000000100111000110100100000110101000010000010010011101000000000001
00010000000001110000100001110110001010000100010000000100000000001001101010100000001100001000000000100
10000011001000010101100000000100010000011000000000000000011000000100001010011100100010111000011000000
00111100110010000000010010000000000000010000000001101000111101011000000110000001000001000101010000101
01100000110001000110010000000000000011001001000010100001000100010001000100100000000010010000000010110
01110000000010011000001010010010001010100101101100001111011001010010110000001100100000000100111000000
00010100001000101011001000001000000000000100000001000000000000011000100101000001000000101100011000010
00001001101110110001000011000001110001001000001010110100000001001010000000011101000000000100110000101
00001100110000110000000100100010000001010000110100000001101010011010001111001010010000101010011001010
00010001000010110101000000010000011000010101001010000000100010010000000000000100011000000000101110110
10000000000000110000110000000100001000100001010010000010000010000101100000001010100010100010011010101
01000100100000000011000010001000001000010011000000100010010001000001000111001000100100100100010010010
00000000010000111000011001000000000000010010011010100010101011000010001001010111100000110001010000110
00000000110001100011000000010000000000101000101101000100000010011001000001111000000000111000000110001
11000010010100010111010000011100100000100000000010001011000110010110000001000000001001000000110000001
11100011000001001000011100000000001010000000001001010100000101100101001000110000000001000010100000001
00000000100000010000010100111110110000100001000010100011000010000010000000010100000111000010000100000
00000000000010000001000000011010000000100110001101010001010000001000110100001010100001000001110000100
00001000100000100000000011010110001010010010011010010001001100010000110000010101010010110101010010000
01000001101000101101110001010000010000000110001000100100010001000000000100100000010001000010000000011
00000101000000011000000000110011100111001010000110011101000101010011000000000101100010000000000011000
00010010101110010010100010100000001000100000101000010010100100000110010001001001000100000001101000001
00000010000011100001110010001100010000000010010000010000110000000101001000100100010010000011010010100
00100000000000001100000100000000001000000000000000100010010000000100000101011000000000100110010000010
10100100000000000001000100100110010100000000000100000000100100010100010000000110010010100110001000110
01000110000100000101001000101010000100100011000110011000111000010000010000000000110100001010000010010
10110010010000000000101101001010001000100100010001010000000010011011011000010010000000100001010010010
01100000000000100100010100000000100000111011000001001010000000101110010011100101001110010000000101000
00000011001110000100010000010010000110110000001010000001000001001011100001011110000010011000000101010
11001000001001010001000100000100011010000110000001000010100101000100100010000000000000010111001001000
00001110011011001100000000000001010110101000100011011001001000011101010111100010000100101000010111000
00000000000001100000010001000001001100100010010100000010100110000011000101100001000000110010000000000
00000001110110000100001001101010010001000110000100111000101100000000000000000000000001101001101000000
00100010000000010000110101100000100000011100000010100001100010100111000110000100001010011101000011100
01010010000000100011000001000001000000000010100111000101001000001100010000101100100001000110101000010
10000101101010011100100010110100100000001000110101100000000010101010101010010001100000010001000001000
00001100110100000100010010110000100101110010001000000010100000000100000100100011110101110000111000001
00101001010000100000000000100000111011010010110101001101001000100011100010000010001000000010101000100
01000000010000000111001010001000001001001001011110100110000101000000000011100101000010000100001010000
10100000010010010010000011001000000000000000000011011001111110001010001001000010010111101100000011000
00001010100010001000110000000010110001010010101001010010100010101100111000001110010000001110000010100
00101000000011010010011000101000000011010010000111100010110100000000000000001000110110001000010000111
01100001101010000000010110000000110010110011000010000010000010010000010000010101100010000000001110000
11000111010100000000001110000110000010111011000100001001000000001000000000001010001010100010000111000
00110010100000111010000010000100000000100000000001000000010000100001010100001100101101010001001000001
00111101000011100100100000001010100110000000000011110000100000000100001000000001000000000100001001110
00000010110101010010000000000000100001001010001000000000011000101011010100100001011001000101000011000
01011100100100010001110010011010100000110010001100000100100110000001000000100000010000000010000010001
01001111001000010100000110111110100001000000100101000110000000010010010000000000000010000000010100000
00001000010010000100001100000001010010000011000001000001101100000000000000111010000100000001100111010
00100000010000010010010000110010010101011001001001001000000110000000010000001010100100010001000010000
00000100001000010101100000110110100000011000100010110000010100100110000100000100001100110011010111010
01010110100001000100010100010011100000110010000001000010000100001100010110010011000000100100010100000
00010001000100000010000001000000110101010000001001100000010000100100101010001001001000101010100000001
10000011010000000000000101011001010100011000000011010110000101000100001000110100000001000000000000000
10111000000110010110100100100011001000010001101000000001001101101000001000001100010111010010011110011
00100000110000000010000000110000100001001000010101000000100101110001000110000010001001000000010000010
00000100000100100011010010100000101000001010000101100010100101001101001111100000000000010110001000000
01011001001100001001100000010100000101001000001000000010000000000011100000110110100000100001000011011
11000000001001001001011001001000010110001100000000100100010000000110110111110110001001100101011010010
10000010101010101101100001011010000110100101011000000000011000100101001000000100100110100000110101011
00000101101011010100101001000000001000010010001110100100000000100100000001101001110000101110000000011
01101110000100000001110100000100000000000000000000100000001100010100101001000000000100010010001100000
00001000110101001010000101110011000100100011010000000010000000001111000100000010000001010110010000010
00110101000011010001110100001101000000101010000111010100010100111000000000001010100110001100100010000
01010000000000000101000100101001001010011011001100101010000000010011000100001000010100101000010100000
10110010001110000010000100100101100001100001000001100101000101001110100010000010100010111010000000010
01010001100000101000110000100010010001001001010100001101001000001100011001000010011110001000000000010
00010010000100110100100110101100100100100010000010000000000101010010000001000001010110100010000010101
01010001001100010100100111000001101001000100011110000000111000001110100000100001100011100010110010001
00011010001000000000000100010000000100100111000010100100000110101000000000000001000100100000000100010
00000000111000100000000110010110001100000000000100001000000110100000000000000000100000000100011011111
01100100100100101110000100111101010000010010000010110001001110000111010110000001000011001001110100001
10111010000011000011100000100001100000100100001110010000000010000101000000000000111011001000001100001
00010100110010000100010000000000110101000011010110110001111010000100011000110000101000000100001100001
00010000000001100001000001010000001000100000100100001010000011000000100100110110010100000010011000000
10000001011000000010000000000100011000001001000101100000001000000000010100000100100000010100110010100
01000101100000001000010000000000000000010100000001000100000010001000010000000001010010000100110101001
10001010001010000110001010000000001111100100000100100001100110111011010000100000101110000001010000001
10000001000010000100011010110000001010000100100000010100000001011010110101100000000000010100000010000
11010000010101010101001000001100001001001001100011000000001001000000010001011000000000000100000001000
00000100001001100000000000000100111000000100110100011000000100010111001010010101001010101011011000100
01010010001111000110000000100000000110010100001010101000111010000000001010101000100000011011000110100
00001000011000000011100001011010011011000001100010000001100000011011010100000100100000000100000101011
00010010100000110000001110001010000001110001000000100000000000010001000110100010000010000001110001000
01001010100000101000101000110000010100011001000011100110101001000110000100110100010000000100010111001
10010000000000001001100101100111101101100000000001001001000111000010001001000010001001000110100100010
00000000000010000100111010001000010010001000000010010010011000010001001000100011000110000100100000010
