10 59
75 1
00100110000000000001100001010001000001000000001101100010001000100100001000100000101100000000100111000
00001000011011101100100000000000000001101100001000110101001000000100000000000000100001011111001000111
01000010001001001001110001001010111010000100101000001000101000010110100001100000000010011010100110011
00001001000100100001000011000110001101100010000110010000000000100111010010011000000100001010000010100
10100000001000001001010100001010000010110000101000001000101100101101000000001001100101000110110000010
00000010001011000011001100011001000000010101101100001001000101011000001010100000010010000101010110110
00101011110000001000000010001000101011110111100001001010111100101000000001011101011101011000100000001
00001011000010000011110000010000010010000000010100011001000110000000000110100000000001011010010110000
01000000000100000011100001001000011010110101010001000001000000011010000010000000001101000000000101000
01001000000111010000000010111001000000101101000101010000001100101000000000000000000001011010001001000
00100001001101011000010000111110001101100001010000000101010000010010000001011001000011100100110010101
10100100100101010000000110000000001100100010000010010011000000001101001101000000000000000100000001111
00000000000110000000100010011000101000101010010000000000001101001101000000000101000000100000000010010
01001001001010001010010001010010001000000000010100000000100011100011010000001110000011000010000000101
11001100110001000010000110100101000000011000000001001000110010000001011000010000101000100001100000000
11000000110100010001011110000100101000000001111010010101100000001110011000000000000100011001101000010
01000000001010001010000000000010000100100000110100000001000010100110100101101101000001010000001001000
00101000001100010001110001100100011010000000100001001001000101110001001000001100001000001000111110101
10100000010000101000100100010100100011000011100010001100010100000000000000001101111100000000000000000
01000010001101010001100001000111100101011000101111000000010100001100001111000100000010000100001001101
00100000001010101000101010010110110010000000000100010001000000100000111001001010010000100000001011001
00010011010010100000000000010010010000100011100010000000011101100000100000101001100010011100001110111
10000000010100100001101010100001101110000001000000000100100000000100010100010000110000101001010101000
00001101001010000000000011100100011000100000000000001110010110010111001001000011000010100000000000011
00010110000001010010000110000000100111010010001000100011000011000000000000101000110101000000101110000
00011011010000000010110101100010100101000010000000000100000111000111000000000000110100100000110000010
00010000010111001100000000001100101011000111010100001101100000000000000000001000110000000010001000110
10011000010110000000100111000011101010000100001001110100110000000100000000010010000111100011100000101
01000001010000110000100010000111011001110010010011010100000110000110000000011000000010101000100000010
00010101000101001101001000001000000110001000000110110000100011100000011100001001100011000011110001001
00000000000010110100001001000001000100110000100000000000010000000000000010000010000110000110010000000
00100000100101001000000010100000010000000000010111000110110110011000001101001100110111001010000100000
00000101001000100000000001010100000000000010000010000010101001110101000100100000000001000010000010000
00100111010000001011101100000010011000000010000010100010010010000000100000000010010000000100000000100
01100000000001000010000100001100110011000010000101000000000000000110000001001000000000101010000001001
00101100001011001000010000010001000000000001000011000110110000000000100001001001110110110101110010101
00000001010010000000000000000110000100000000001010000000101000010001000100100000000010001001111000101
01000001001000000000100000000010000100000001100010000010000100001000000011011001000000000011000100000
10001001100011000000000000110001101001000011011000100000001001101000000000000000000010100000000000001
10000101010100000100000000000010000001000000011101100001000001010000000000000000010011011110110000111
00010100010000000000101100001000000000100000010010000011001001101000001000110001100001000100100100000
10000001010000100100000101100000000100001100100100000100110000010000000100000100000100001011000010010
00001010000000010100000100011000000010000010000010011000000000000000100000000101010101000000001101111
00010000100010000011010000011101010001001001001110011000000100000010000100001001000110000000000000001
10000111000001100100001010000001110100001100010100100010010001000000001010001100010101010001010011010
01000000100010000001111001000010011100000000011000011011100001000000100000011000110001001000000100100
00100100000101010101000010001000000001001001100001001011000001011001001000000011000000101000001101001
00001100000111110001100000000100010000000100000111000000010010000111010010100011010010000010101101010
11010010001100000100010100111000101100100000100000100111011100000001000010001010100001100100110100010
10000010000001000000000111001100010001000000000001011101100010000001000001101101101011010000000101010
00000110010011110001001010010001000100010000000000000000000001010100010101100010011101011100011000001
00000000001000010010000100100001000000000000100010000101000001010100100100010000110001000000001100010
10001000101001011101000010000010000001001100010100100010110000110010000000100101000000001110001010001
01000100010011001100100000001011001010100010010001000111000000101110010010111100100100000100000010000
01011001000011100000000101100000100000110100001000001100101110100100010000111001010100100000000010011
00000000010110001001100100010100010011000001000000010011000000001101010000000001000100100010001011101
00000011000000010001101001111110010000000010001100101000000010100000100001011001010101100000111111010
01000010101011011000000000100001000010100100010001000010100111000010000010000000100000100010010000000
01001000010000010010101000000110000110100000100000101000011001110001000000100010001101111011001110010
00100010000100000000111010000001100010001000100010010110000001110011010001000000100000000000010100101
10100110010011010010010000000100101000001000000000001100011011001001000001000010010010100100000100010
00010000001100110000000001000011001000000001100000110101101010010001000100000001100010010010010011001
10101011000011000000001001000000001000000000000011000000100010100010010000001101010010011000010000000
10010010000000010000001001000110011010010011100010010111000100011000011000100110010010010000101101000
11011010010010000101001000000101100000110110010000100001001010010000001111000000101010100000010010000
01110000000011000010111001000010100000100010001000011101001000000100000010000111000100110101000001101
00000110100010010001010010100100000100001001010100000001100000110100000100000010000001000001000000000
00000101000100011000010001010000000000110000101000010111000100010000010011100100011001000000000000010
00000101000001000000010100000000110000011100000010001000010100110001001000010110100000010010100000000
00100001001110000100110010010010000010010010101000001000001010000100100100000001010000000010011001000
10000001000010101001001010000110001000111000011000001100010110000000000000001100100001010101000000000
10000000100001001011011001000000000101000100001000010111010010101000010101000101000000010000000110000
00000000100110000011010110000000100111001110100100100100100000000010000010001100000101001101000010110
00000011110101010000100100001000010011000000001000010010011000100000011100010000001000000001000000001
10100101000010000100100000000000101000010010110101100001000000010000001000000100000000110110000100000
00001001011010000100010100000111000000000101001000011001010001010011001100100000010001110011001001000
01000110001100000010000001111001010011001000110000000000000001001010000100000010000000001000101000100
00000011000000000000010010001000110010000010001010110110100100000010010111010000101111100100010101010
01000101000110001010000100000100110000000010000010100000101011000100000010010000000110000111000010001
10000000100011001001110010000001010000101000100101100011100100010101011001000000000100111001010001001
01000100111010000000001001001100010110010000100001001001011010100000000011011010000000000010000000100
11000110101000000010001100000101001101001000001100001000110000011001000110010010100100000010010011010
00001010101111010010000100000110011000010000100100000010010000010010000001000000100001000000000011000
00110001110001001000000000001110100010000010110000101000010011010110101101010000000101000001000000000
10101010011100000111011000000000000100100000000100011101010100010010011001000100000010000000010100010
01100001000000000000111000100010000010010000000100000010111000000100000000000000000001000011110001000
00011101110001000100000100100000001000000001100000000000000000101001010000000000001000000010100111001
01100000110000001101010100001001000100000001000100101100000000101010001010000000000010011000111000101
11100010000001000010000010110101000010101000001000000100100000001000000000010110010110011010010110110
00100010000000010100010101001101100000100010100100001001001000100000000000001000011010000101010100100
00100100100110000000110101001100001000000001000000001010100001000010000001010000001110000000101000000
00001000000000100000110000010000001000100010000000001100000100000000000000100110000001000000001011001
00000100101100110001001000100101010010011010010001001000101010000000000000000001100101100010000100111
00000001100001000000000110000001100110010000001100010100001000101000001100100101110110100001000000000
00001000000000111001100100000101110010000001000100100000101001000010000100100000001001000010100101000
11101010000000000000010101011000000011100110101000100000110001000110000010001010111010011010000000000
00010000100110010100000010000011110101010010000001100110010100011000010001010010100010100110100110001
00001000100011000000100010100100001100000100000001011000100101000100110010000001000011001011100010010
00001111000000011011001000000000010010010111000001010000000010010000110111000001100000000010001111000
00000100000000011011000010110110000001010000001001001100010011000001011100000001000000111101011000110
00001000111000010001100001010100100001001000000001000000100100000010010000001001001001010000010001001
