79 73
12 23
00000000110000000010000010000000110011000101100010011001110001101001100100001100000000001100001010010
01001110101100101000000101000000010000000100000000000100000000000010111000101000100100100101001010000
10001001001011010101110000100000000000001000010001000100000101000000000001100000011010001000000100000
01100000001011010100001000010001001011000110101001100111010001000000100000000001011100000110001010010
10011000001010000111100010011000110000000100111100000000110001000001001000000010000010000001010000000
01000111110011001000001000100011001000000000010101001011100100010001000000000100001000001000000001011
00000000100000010000010110100010001000010000001010000000001111100000000010000100011100001011101000001
10101001000010000111011000100001100000110010100110000010001000000000010000000110000000000101100100001
00010001000110100001101011100000000101000000000010100011100000001000011100100010010110010000010001000
01100010100010000010011000000100000000001001010100011000100100100010111001000010011001010000100001000
00000000000000100000000011010100010001000000010100100000010001101000100001100000100001100000111110001
11001010000001000000001000001000100011000000000010100001000001001010101000101010000010101000000100000
00111000100100101000000010000110010001000000110000000011100010000011111000000000011010100010000000100
01011010000110001001011011000011100000100000100000100110010001000001010001011011001001011011111100100
10000001000101011000000010001010000100000100000000100100101010000001100000011010000010000100000000110
10000011101001110000101101011001001000001110011100000000000000010101001001000000110101010010000000001
00100010000000000100010000100010010000100010000001101000010101000000111001000010010001101101101000110
00000101001000101100100000010101011000110011000001000001000000000100001100101000010000001010000001011
00001111100000000100100001000000010000101100000001000100000000000000100111010110000000100000100011010
01000000011001110101011001110000000110100000000000100000011000100000000100110101100001000000001010000
01110000000010000000110010000000101001100101100101001000110101000000110101111011000001101010101011000
00100101000011000001011011110000001110000010010000000110000100100000110001001100010010000011100000000
00010000000100001010000011100001010000001110000000010010111010001010100011000001001000011000000100101
10010001001010001000001100011010100000101001000000100100100100000000000011010101000101000100100100000
10001100000000011001100010001001010010000000101100000010000010100100000000101010000000010110001000000
00110010100000000011010010000011100000000000000100010011100001000000010000100011100111011000100100001
10001110011010000001001000001100011000100001110100100101000000001101100111110001101110000000110001000
00001100111000011000001000010011101111101001101000000011001010001000111011001011111010010000010101000
00000000001110000000000110010101001100000101011010000010000000101000001100010100000100100101000000000
10000000000110010100010000100000110100111000010000001100100010011010010001010010010100000101110011000
11010000001000010010101011100000111000000000101101100110000010100100000010101000000001000000010011000
00000000000000000000010000111011001001100001100010010100000001010001111000100000000100101111001000100
10001100000000001000000100000100101101000001000100000100001010101000101100000110000100001000000110000
01100110001000000001000001000000000010001110001000010000010010000100000000001101101000010011010010000
00000001100000000000111000000010100000001100000101000001010100000011100001100101010010000010010010001
01000000001000100010001110010100100001000010110010001110000000000000001100010110000000001010011000001
10000000000000100100000001000000010010101011010001100101000001000100010010010010000010000000100001000
00000010000001101010000010001001000000010100100000001000011000000110010000100011110000010000001000010
01000000000100100100000000100001100011100000000000001100000001000100000001000001000001000000000000100
00000000101000010000000000001100000000110000000000111000100001000110000001101001000001110100101100110
00101010011110100000010001000100111101010101101001001101000000100000000100000100000010100000000000010
01000100010010000011000100100000010100010000110000101010010001010000010100000110010111110101000000010
10100010010100000010010000110001010000011010000100001101000000000010000000111101010000001011000000110
00010100101001000000000000101010101100010100001010011000110000000010010000010110110001000010000001100
00000010001010000110001000000001001010001110011100010100000001010001000011101001011001001010000101000
01010100000000100001110100110010111001001000000000110001000001100110000100000100000000010011000000000
00100100000011000000110000000000011010000100000001000100010000011010000110000011110000100000000001100
11000001000000000111000010100010000000000001100001000000001110000110010010011001010100001000000001000
01111000100010111100000010100000000100001000010000010010001000011010010011010001101110001110110001100
00100000000000011000110100101100010111111100110100010000001110000100011000010000001001010001010100101
11000010000011101100000010001010110100000011010110001010010000001001000000001001000010100100000001000
01001001101000101001001000000101000100100000010101110001010000000001100001010011101110011011000011010
00010000100100110000100110000000100100110100000111100000000101010110100001000010000000100011100000010
01110000110001000001001000001001000000100001100000011100000001000110001100000110100010010000001000100
00101100000111000110000001100100011100010001000000001000110000001010001011000000001101100001000100100
00100000100000100100000100100011000000000011001111100000000100010000111101001000000100001100000001100
10010001000000110000000000110101100001100000100111000000111000000001010000000100000100000000110010110
00000100000110011001001000100010101000000100001000001000000010000011100110000000001010010010001001000
00010000000010100100100010010001111001010000010100000010000011000000000010100010100010001100010010101
10100000110010000101010000000010000010000000001000100010000000100100010010000110010000000000000001001
00001110110001101100000000000100010110001001011000000000010011011110101000001000001011010111010000010
11011000101010111010001110101100000010110000100010000000100110000010011001111010000100000111100101101
01001101010110011000000011100001111011100100010010011010000001100001100000010100010000001100001000010
11000010010000000000100011000010100000011100000010000001000100000000011000101000000101000111000100000
01000101110001001000011000110010001010000100010001000000010100100010100000100011000011001010010100001
00000000100000110100000100000110111010101000000000000010101000000010100110001010000100101100000010010
01010110001100010001000000001100011000000001000010000100010100101010000010000010110000110010111010000
01000000001101010010010011000010010010100010000001101101001101001010001000000000110001000010001010101
01100000010001000000000000010100100100000010100000000000110101010111000100010000000001001000000001011
00001000110001001100010110001001000010001100000101110001100100000000000111000000000001100000000010000
00000001100010100100000100100110110000111010010110000110000000000001000000011011001100100001101101000
01010100001011100000011001000010100110001010000001000100001111011001101010000000100100000010000110011
00011010100010001000010000011000001010000000010000110100000000000100001000000000100001001101100100000
00000110010100100100100011011000000010000010010101000001001000010011000000000111101100000010000111010
00000010101000000000000100000100010100110101010000101110100000000100000010101000000000000010001100100
00000001100000110001000010000010110000000100011010100000000011000000100011010010011010010011000000100
10001010100001000000000011000000000010110100001011001000010001010011011100001001110110000010111010000
11001010101011000011011010010010000001001000110100001100110010110110000011100010101000100100000000101
01000010010110000100101010010000001010101010100000000011001000001100001000110000001010011011000001010
01101000110010001010000001000010000100010100010100100000000000010000100100101100000010010100000101101
00000000000010100010001000000000010000100110000000000101000000000001011011110101100011100101000000000
10000000000100010001000000000101010000001000100001000001000000000101110010001001000001011011000001000
00001000010010000010010011000100001001000000000000011110010001101000100100011010001000100000010011000
10011010100000110000000000010000000101010101001000000011001001000101010110000000100100001100100110001
01101100000011010000011011000001100100001000100101010000000101101000000110110000000000000000110000000
00100000100100000010010110000000010000100001100001100000000010000001111100000010110001010000000110011
00000000111001010110001001000000000001010000001001010000000000100110010000010011010110101000000011001
00000001010100001000000000000010010000101001001000000100010010000001010100000010101000100111011100000
10000010011001110110000100010000001000000101010100011101100100010110100100010000000001000001100100001
00011101000000000010000000101000000100000000000000001101010010000001100100101011100000000100110111000
11000010001100010000011101001011100000010000101010000000001000010100100110110010110000001000010010000
00110101101001001010110000010100110001010001000000010000010010000100010100001000011000010100010000000
00001000000110000011001010110010001010011101010000000000010000001010000100100100010100100010001000110
11100110100000100011000101001011010000000000100000001000000000101100100111100100000101101110000100000
00000000001101001001010001000011000000000000000000100000100010000001100000000001100000100010110010010
10010000010000110000101101001011100010000101100001010110000011001100010101011000000100010000011000001
00100100010001010000010000000010100001001100010100000000000000000110010001101000000010110010001001100
10010010111001010000111010001110100000000001000001000110101011011001101001010101110101101100000000010
00001000000001000000000000110000000000001010110000000000111010000001000010000010000110001000001101001
00000100001110001010000000011100000000100100010001000100000100001000000001010010000110110010100000001
10110001010010101000010001000001000001000110000001000000111000100010011000011100000101000100001000010
