88 94
94 26
00111000011001100001101000001000110000111000000110000001100001000001100001111111000011000000000010010
00000100000010001000010000000010010101001000100101000001110000100000000111000000000000010000100110001
10010001000010000100010000100100000010100000000000011000000100100000100000001100000010110011000110000
00010010101001000010010010010100000000101111000011000010100001100000000100000001011001000000110000101
00001110011000000000110000010111101000100000100000000000010110001111100000110101000000000010101010000
01000001000010100000001011000001000000000100010010000000110001000000001000011010001111100011011100110
01001001001011110000000000000001001110100010000001010101001010000001101100011000100010000110000011100
00100101000100000000100000100001001010101000011010100101001110000001010101100000010000001010001010001
11011010100110100001001000110000000101000100000011010100110001101001010000000010011010001010000001101
10110101010001010000101000100100011000100111001111000110100001000100000101100001010000011010010001000
10000100000100101011100001010000110000110001000000001000001000100100100011010001000000010100001000100
00000110110000001110000000000110000101010000000001001010000100111100000100101010010000000000100100001
00000101100100010100110000100100000011001111000010001001100000100000000010001001001000100001000100000
01110000010111000000000000100110001101100100110000000010101010110110001001011000010100000010000000000
00100101000001000000011001001010100010110010000000111000101000000000000101000000111111001001000000100
01000000000110011001000000000000000100000100000100101100000100000100100000110100101010010100100110100
00010100000001010010000010000010110100010100010011110101011000111001001010000011000000011100000010010
10110000000000000011101001000110100111000000000000001000100001100001101101000101001111010110000000000
10100000111000000010000000000101001100100100011001010001000000000101000000011100000110010110100000000
00010000000011000010100010000000000000000000000000110011001001100010010001100111100000011110000000000
10101001000101001100000100010100001100110001000100101000011010000000010101010010001101001001000000101
10110010000101001110010001001000010110010000000001001011110100000000011000001000000010000000000001101
01001101000000110000000100000001000100010100100000100000011110010000010110000100001000001001000010001
10100000000000100101111000010000010110011000001001010100010001100001101101000000000110010000010010010
10010000111011000000010011001100010100001000000001000110100010011110001100011001010000000001001000010
00010011000000011000001100000010010111001000000000000000000110010001101000001010010010100010101000000
00111001101011100000001001011100010111011010000001000000100010000001011010001000101000000001010000001
00100000100010011010101000000001100100100101100100100001010011000001000011100000011000000001010000000
00000001000000100000100000100000000000110100101010100101000000011100110011111111000100010000010000100
00000110000000001011000011011110010110101010001010000001010011001110000100000101011001000000000000100
10010000001001010000101001010100000000101100010110101110100000010010110000000011001111010101010010100
00000001000000100001110110100011000100010101100000100101100000110001000110100100001011010101001000000
00000000000011000000000000010001000100000001101000010001001000100010000000001001100101000010000000011
00000000000101000100110100100000001010000010111101001001000010101000001000010011100101000110101010000
00011110100101001000001001011000010000001101000110001010100000100100000000100000001111011010000100001
00110000001100110011110101100000101001100010110010101001010100000000101000000000011000100101101011000
10100000010100000000001001001111000010100100010000001100010000011100001010000111000101100011000110101
00001110011001010000001110000100100000000101001001001010000010001000000110100001001100000000110100000
00011100000100000011100100010000100011001101010111010010101000000001011001010000110000100110000000111
11000010110100100000001000100110000011100010010110000010000000100100011000100101100001011001100100000
00100001000100011001110000001100011010001000001000000000000011100000010000000010100000010011000000000
10111100100001011001000100100100100101001010000000100000000001010111001010100000100100000000110000010
00000000000000110000011000101011000101010110000100000010010000101000011000100000100110010100001010000
10000010001010011101010000000010011010110110000001001110000000000001000001010010010001001000011001000
00000000010110000111001101000100010000000100101110100011010011000100100001010000000001100100010010101
11101100110000111000010010010001010100000010011010110000000100100000000010100100100000100000001000010
10100000100110010010000000111001000001010111000001000100000011000000000010100100100010000000100100000
00100011001110100000001000001101100000000000010000010001100001100000000000011100010001010100000000000
10000101000010010110000000100101100011000001010010000100001010110000000010101001110100010000000011100
01000000101100000000010110101110000011001011010001111000100100001000000000010000010001110111000000100
01000000000101000001011011000010100000011000000100110111011101100000000010101101000100100010000001001
10000001010110000001100000010110001000111100101100101000101011100000000010110010101000010000000110100
01000111010100100100101000100010000101100000110010110110001010010011000011100001000010010001100011010
01001000100000000010001010001110110001011010000100101100000100010001101001010000110001101000101000000
01000100010100100000110101011000001000000001001000010010010000100000000010000011011000001000110000100
00000000000001000100000010000100000000000101001101000010010000000001111000000101100010001101010110110
01111010000010010011110011001000001000101011000100101011110111010010000000000000010101010101100000000
00010000010000000001010101100000101100100100101010100000001100111000010000000000000100001010000100000
01001110010000110000000000010010010001000000000100000101001000000000110111010101000010010110111100000
01000000010001000000010111100110000011010000001000000100011100110010000010100000001011001000000000000
11110000000000000010000010010000001100000100001000011110000011010010111000110000001001011000000001001
00000011000101001001010001010000001101001111000000000011001101000110101000100100000000010100100001100
00000011100000001000010011000100110111000000000000100010101110110000110010000000100010010001000000000
10001000000000000001100110000000000000100000000010101000000000001100100000001000010000000101100010000
00001000000100100000010100011001000010010100010001001000010010000000000000100110011000011000011011000
00010000100001001000100000000011000000010100010010001000001001000000000101001000000001010000000010111
00000101011000111110010110000000100000001000010001000010100000101101000110000101000000110110000001100
00101101010010000100101010111110001100011001000011011010110000110001100001001001000001101000100011000
01010100100011001000001010001010110101010010000000010011000000001010010010000110000110100001001000010
00000000110011011010000010001001111000000011111001000010101000110000001110000000000010001110001011000
00000011001110000000100001100010000100000100001100000001000000000010101101010000001000010010100000000
00000000110000100100000011010010000110010010010000001001000001010010100000001011110000010101010100100
10001010001000000000010000011100010101001010000011000000100011110111000000101000001000000010110101001
00101010010100010000100000010011011001100010110000010010100000011100110000001111011000101110000000001
11000010110000100010110001101000010000101110000000001100101100011000100100011000100010000100000000000
10101110001000000000100000001000000010000101110010000001100000000100000100101000000001000010000100011
01000011110010011010000010000000000101100010001101110001010001001000000000001000011000001100101100000
01000010000000010000011001111001010010101010000001100011010100000010110010001000000001101000100011010
00110110110100110011010000100000001011110000000000001100000010001001110000010000000000001001100000010
00010000000000111010100000101000000010001001110010000010000001001100001001010000101000001011000111010
00100001000001000000010100001110000000110010001000110000000000000000000000010010000000100000000100000
01000010110000010110011000000001001000000001011000100100011001000010011101000001100100101000000110010
10000001100110010010100010100000101110000001101011000101001111011011011100000000000000000011000011100
10000100000000100000110000000010000000011101000100100100000000110000000100011000000000000011001001011
00011000000010010001000000001000100100000111000000100010001011011000001000101001011000001000001000110
00000010010101000100010000010000001001110011000000110000000100000010010100100110010001000000010010110
11000110011001100000111010001110001000010110001001000000100000011010000001001010100000000000000001000
01000000100010011001100010000000000010010100000001101100000010010001110011011000110001100001000001001
10010100100010100000010000000000010101011001011110000110100010010100000000100100100000000101010000000
10000000011000001110000000001010100000000000001101000000010100001011000000111101010100001000001001000
00001000000010001000010101001000010000000000000100111000001111110100100001100001011001000100001001000
10011000000001010010010100100010100000010010011010010011000001001000001010001001000000110000010011111
10000000000010100100001100001000001000010000000100001100000010100111000001001000100001100001000100100
01111101000010101000000000001010110000010111101100100001000001000000011000101100100001000010001000010
00001000101000001000010010001100010001011001111000100110100000011000000101110001000101010000011001100
00110000000000001000000100000010001101100000000000000001010011000001000000000001101000101010010001110
00101000000010000000000001011000000010000001011000101001000000000100100000011100010010001000101010000
00010001010000110000000101101000100100000001001000000000000100101000000111000000100000000001010101110
10101000000010010010001010100100110011010000000101001010000000000011000100000010000010000001110000000
00000000001011000010110001000101100000100101110000110001010010001010101000000001001010110010001000101
00000100000000101011000001001010110001001000100000000000011011010010000110000100101000000001000000000
