43 73
90 28
01000100110010000001100000000011011011000100000010101000011001110010110110110100000000000101011010000
10100001100000000010000000000000000100000010111000011011101000000001000101000000000000000000010001010
00111001101000110000011000000100011010101001001000010010000110111100000000100001000011000000011110011
01110100000000001010010011000110000010000001111000100000010000000011100011110100001000110110100100011
10010100010100111010000000100000001010100000000010010000001000000111000100001000100100110000000111100
10101000010001001000001110010010000000010010000001010000000100100000010001011001000000011000001000001
01011111000001010100101000000011100000010001000110100000010000000000000100110000000000000101001000100
00010010100000000011000100101000010010001010100100010000011100001010011010100000101000100000001100001
00011000100100000000000011000111001001000001001000000000000000000000100100010000100000101110000010000
10100010000010010010111110000011010101010000111010000000110011100000000000001010100011100000000101001
00000001000100000100000001010011110011000010010000001001001111110010000000110100011000110100101111011
00000000100001000000100010000100010000100110001000001011010100000010001000000000010000000000011001100
01011111011000110000100000001111010000110000001001010100000001010000001000110001000000010000100000110
00000010101000100000110100011000000000000111101010000001000000010000000000110100110010000111101000011
00001110100101001000000010010000000100000000100000000100101111110010100010100001100000111101100010000
00000000011110001010000100100000100000000000001100010110000000100000000000001000101000100000000100000
00000000000000000100001111010000010100000010110110100010000001000011110001000010000010100000001010000
01010100010000011101000001001010001000011000100101100000100110001101000001000100010101010010000010101
00011100000010010000100110100001100100101100100110000000001010010100001100100101100010111101001000000
01000000101001001010001100010111100000000110000110010001111001000100100000001100001011101001000000100
10100000000010101000101000001000111000110110110100000000010000001010101000110010011101000011001000001
00000101010000101110010110110100100000000001000010000010010100000110111111001001110011101001101001000
01111001000110101000001011010000101001001100000000101001101110000010100000010000000100000000010000110
00100001101000000000001000101000000000000010000011100010010000001010100010000010011000001110100100000
00000010000100100100000001011010100001000011010010100110000000011000100001001010110000001100100100100
11100000000000010100100001010000110011011100000011000100011001100010100010101100001110100000000100010
10001011011110010000010101101000000000100100100010100100110110100000000000000010010000100000101100001
00000100011010011000010111000000110000100010101000010001010000001001100110110010100100011000000000010
01010101010000000010110000000001001000010000000000010100101101000101100000000000101000010000000011000
00001010101000000001000000001000001010100000100000000000110100010101010011101000010010101011101011101
11000110100000111011001001000100000110000011000001100000010000100000001001100000101000010100011000000
01111000000000001011010000001010101001100010000000010001000100000000100000010011011011000100000100000
10101101000011000000000001101000000000010010110000110000001000000110000000000000010010101001100000111
01000000100010000001000000000000101000100100000001100010010000000000110000111100011100000000000101000
01010011001000000100000011110000101000000001110101001000000000010000010000001000100110000000000000001
11000110000100000010000000000011010001000100010010000000000100000001010101000010010000001010000000100
00100000001010000100001000010010100000010000110010001001101001100011010100101000000111110010010000110
00001010010101010000000001101001101001000001100110000011010100110110000000001100001010100000000101001
00100100001001100100010000000100000100000111101001000000001000000100001100001001000101000000000001000
00001100001101000000100001010010000010000000000000110000100001010111001001011000000000010000100000000
00001000000001100000000001001101011110101000101000000011000000101100000000000100000010011000000000100
00110001100110110000011001000011001000000010000000000010000110010001101000000000111000001010001000010
01010000000010011100000000110111000101001011001000001010001001010100000000000101100000000010000101000
00001000001011000111110101001100000000000111000100000000011101000000001000001011011000000011000010100
00010110001100000111100001111001100000100000000001000001010001010101001111110101000010111101010000100
10010110000000100000111000101010010100000100111001100100000000000011001001011100010000100001001001001
00000000111001001010001000111000110101110101000000000000000100000100101000000100101000101101000011000
00001000000000000000000000000000001100000000001000001100000100000000000100101001111010000000010000100
01010000000001000000000111010001000100000000000110011110001000000010110000010100010000000001100000000
00000000100100011101100001000100000101010000101000010000000010001001000000001000010101100010010100010
01010010000100100010010000100000101000010000100000000101010010000100000100000011000101111001101100110
01000010000000001000000110010001000000001010000100111000000100000100000001101011001101000000111000001
01000100000011100010010100010000110001010101110101100000000000001110101100110100000001000000000001000
00011010010000010001100000100000100010000010101001000011000010001010010110010101101001000010000000110
00000001111010010010101001010011000001110000110011010001010110011011000000000000000000000000000000010
11100011000011001010000100011100000011100100110101001010100000000010011000001100001110000000100000101
10100010100101000000001011000000010000101010100010000000010000011110001000100000100111010000100010000
00000000011011001110010010011000110001001011001000001000001000000000000110101001010000000100001000000
00000100011101000101100110000001011010011000101001101000001100001000100000000000000000010110010000001
00010000010100001000010001001110000000010000100010001010010000000010100000000110010001100000010010101
11001110010000100010101001100010110011100001100100100000000001000010100010000000000100010001101101001
00000110101101001001001000010000100000000001010001110011101101000000010000110010010000000101100000010
00001000100000100011000000001001000000010001010001010000000010010001000000000010000111001000001101100
10000000110001001001000000000000101001010000011100000000001000101000001000000001011000010000001010001
00010100000100000010100011100000011011101101100000000000011000101000000001000001001100010011000101100
01000100001010010110001111010000000000001000000010101000000000000100100000101000110111010001100000000
00001010000011011011000100000000101010010100000100001010000100010001100000100001010000100001100000100
11101000111000010000001000000010000000011100000010010100001000000010100000011011010100100110100111001
00000001010110010000110101000010111011101000000000000001000001111011000010001010000000010101101000100
01001000000010010001010100010000100001010100100001000000000111110000001100110000010000010001010001000
11000010000000001001111100001001000000001010000000001000100000010101001000001001011011011010100000000
10000010010100100000000000010001010001000101000001000000001110010000000100000101000100110000001001011
11110000001110011000001000010110110100000001001010001011000101111110100101111000100100100000000001100
00010100011000010100010000100101000011000101001000010100011000000001101010000010000010000010100110011
00000001110001101010000000111101000000100110001101000000001000101001000000000000000000010000100010000
00000011100100000110000001101001010011001000011100000010000000010110000010100000000001110010101001011
00100100000000000001100001100001110101000000000010011000110101101001100001000000001010100001000010100
11111010100000101010010111011010101101111000100110110100100010000000010001010110100000101101000010000
00011111001000000101001000001010000100001101001000001001000010000000010000001011011111010010010101000
10010001100110001100000001011100110010010100101100110001110010111001111000010001100000000001001000001
10000100000010001101000001000010000100001100000001101001000010010000001000010111000010000000000101000
10100110000100011000100101100000110100100000000001101100100000100001000111001010000100000100000110000
10010000000000010000000000011000000111110000001100101010000111000010001000100110001000001000010000011
01000010000001100001101000101111101000010000000001010000010100000001010010100010110101101010101001001
00100101110000101010010000010001000100100010000001100101011000100010000001000100000100010000111010110
00000000001000101011000111100010010011000101100000000001000000001001001101000010110110001000001001000
00010000000011010000000001010000011101100001000000101100110010000001000000100000000000100100001001001
10000001100010101000101000100010100000011010000000000001000000100000000101000100100000000000011001000
10100000010010000100001000010000100111101000100010010001000100000000010010001011000000001000000000000
00010100011010010100100101111000100010000110010000011000010001001000000000000110000000001110010001110
01111000000001100010000000000100011000000000110110110011010001101101000010001000100000011000000001000
01101100010001110101000000000001000000010001100010010010101001101001000011001011101011000000010000011
00000010011001010101110100100001000001001000000101000000100001010011001110000001011000001000010100000
01000000001101010001010000111000001000010100000010011000000000010001110001010011000100000000001000001
00001000001101000100011000110010010000001000000000100010100001000000000001110101111100001000000000000
00101000000011011001001011100000001110001000001100000100001000000000001010010000010100100000000011000
00100001011000110100010111110001000100100001101010011000000010001100000000110100100000000000000100000
01000100101110001000000000000000101000000011010001100100000001110000001110100011011100100011001100010
01110010010000000111010010000000000100100000000100000000100111000010000100001101000000010010100000110
00000011010000100001110000110000000000011000101000001010101001101000000000100110000101101000000101110
00010100100010000001000001000001000001100000010010110000000000000010110000100110011001100000000001000
