21 22
73 70
00011101001000000000000000001011000001001110100001000000010000100110000101001011100110101000000100000
00000100000000000000001000010110110010000000001000010011010010000010000010010000100100100000100101010
10001001001100110001001000100010010000000000000000000000000011010000011001000001100001000000000011000
00001000000101001011000100000010001000000100011100010001000010101100000000000010010001100001000000100
10100011011001001000100000000010101001000000000000100000100111001000001001011001000010001110011010010
00010110000001000010000010010001000100000100110000110010011001000000000010100110110100101000000010000
00001010100000011110100100000100010010000000001000000100000000100010100000001000110010010001000001000
01010011100110000100001000010000000000000011000001100110001100100011101000110000010010000110011100100
00100000010110100001110011001000010010100010000100001000000000100000010101001000110100100010010000000
10011000010001010100101001001000000000101001011001001000101000000100010000100000111100010010000100000
01011100000110010100100001000000000011100010011010111000101000010011110101000000001010000100001011001
11000110100100000001001010001000110110100010100011011000010000000101000001001001000010000110000001011
01001100100110000000101010100000000010001010001000000100000010000000000100001000000011000000110000010
00100000010000010001000010100000001000100110011110010111100000001111000000011100000100000000001010001
00001000000001110001010000100000101011000000010000110011011000000010100011100100111010100001100010010
00011000111001000000110011010001100100111010010101101110010111101000100001010100000101000000000010010
00001100100000101110100101100101001000101000000101100111001000100001010100001000000010100010101000101
01001000100111000111110100000001000010101000100001000101100000001010011101011000000001001000000000001
00000010000000100001000100010000010011000010100110100000010100100000000000000011010000001101100110010
00001010001001001000001100011011000001001010000011110011000000000011000000000000000010111001110001110
01000000000010100010010000000000000000000010001100010110101010000011101101100000000000100101011000010
10100111000000100100100000110000000100000011010000000101001000101100001001000001100001000100010100010
01001000010110001101001001100101011000000100100000110000010100100101001000000001001000000001001010000
10010000000100100001010010110110010000011111101101100010000001010011011001000001000001011001000100000
10010001000000000000000110000001001100000000000000001100001001000000010011000000110000010111001000001
11011001001001010000000000010000100000001010001100000010001000100100011001100111101101100000000000100
00010100001001000011000001000001000000000000010001000000011000101000011000000100000001010101000000000
00010010101001000000100000000010000000000010011010000000001001010000110000010101010100110001000110010
01000100100000100001010100010100111000000000001011000000010000000000010010000110000000110000011000011
00010001000001101010011101000001011000010001010000101000010001101000000000000010100101100110100100100
00110010000000101000010101101100101100001010001000000000010000000000010001011010101011011001000110000
00001001110000100000001110010000100001000011011000100010001010000100010001001001100111101011101010000
10100100100000001110101000001001000100010010000000000100110100000001010010010100010100000110010100001
01010100000011100000000111000000010000010000100111100000001000000101000000111100000000110001000110110
10000000010101001010001110001010100100000100110011001000001101011000000011000001001000100000010101000
11100000001100001101001011000001101000010011001000000010010011100000010011000010010011000000001100101
00100000000010000011000100011110101000000110001000110100101000000101100001000000000101100000000010001
10101011000011100010010000000000000100011011000000000000010010001101001000001110100000100000100000010
01100111011000100100000000000101001000001011000101000011001010000100100010001000000010000000111010000
01011000010110100001100100000011000000000101000100101000000000001000100110000010000000100011011000100
00000100000000010000011000001011000001000001101001000100100100101010000100010000000101001001100000000
00000001001000000100101000010000000000011000110100011010000011010000100010010101000101010101010000000
00000010010000001101000000000000000000110110100000000100100101000101001010000000100011111011100110100
00111101110001001100001100000000011110101000000100000010110110001000100111100001010000000000100100111
00000111111010001110001000011001001000010101000100000100000000000010001001001000111110010100000100000
10100000000001010011000000000100100000101000011000000001100000100001101000000001000001101001100011010
00010000011001000000101000101000010010000010100100000000000000011100010101000000110101000001000001000
10100000000010010000010100010011100000010010000100000100000000010110000000110010000000100001010000000
00001010100001010110000100000000010110000101101000000010000010100100000000100001000000001010000010100
00000001011110000000100110100000010100000111001000010000101000010010110100000100001101000000001000001
00101000000001000101010010000011000110100000000011100000000100010101000010111000000001010001010000100
00100100000000001000100010101001011100101000000011100100100100010100000011010001001101000001000010100
00110100001001101110000100000000000000100000000000000000010010100100000100010001001000101110000100001
01110000000000000011100000000001000111001000110000000010000011000011000010010100100010001010010101010
00001110110011001011001010010000000000010000100100001100110010000010101010100000110100010100000000111
10000110000100100100001001000010100010100010001010010110000001001010010111000011010100011000001100100
01000000010010000100110110000010000000010011010110011000001000001011000100001000110100000001000000111
00011001001000010010000000010110001011101100001000010101001000000001000000000011100010110000100000000
00011000010000010001000001010100000000010010010011010000001001100100001000000001101110000101100000000
00101100101011100000100010010011001001000100011001010000000000000000000101101110001101010000110000110
01000000100000001100101010011000110010010011001001000010010000101000100110100100000000100000010111000
00000110010100000100100001011000110100101000100000000001011000101010000011010010101011001000100000011
01000011000001010000100100100000110010000000000000000010000010100011100000100001000000000100011001111
00100100001000101000001000010110101000000100101000000101000010101000100110100010010000000110011100000
10001111111010000101010000000100011000000001001111000000100110011000100010101100001010000011100001011
00010000100100011000001010100010001001000001000100010000000000000010000110000000000000001101000000010
10000010001000010110000101100100010000100011001010001100000100000100000101010110000011100110001001000
10100000010110001010101010000010000101100001101100000000100011110000001001000000011000000001100010110
00011100110011100101000100011000010000000000000010010101001010110101000100000000001010101011001000011
00100000100011000000010101000000100001010101100100100000000010011000000011000000000001000100111000010
01010101000101100000000001000010000100000011100100011100000000001010010000010001001100101000001011000
00010010010000100100001000000011001111010000101010000000000000001100100001101000000001010011100010000
00001100000100100100000100001000001001110101011100000100101100011001100010001100000000100001100010000
10111000110010000000000000000000010001000010100011010000110001010000000000001010100100000100000000001
10011001001110001010000001011001010000011100000110100000000000001000000000101001011100001000101010010
00010001000100010000010001101110000000010000000000001100010100110110101110010000000010000000100000000
00100010000000001000000000000000000000000010101000010001000100100000001001001000000010000001000001100
01001100001101010010100100000000000100000000011100000100000001000010100100001110010000000000100001110
00100000100000101110001010100110011010100000000000011010001100001100000010000110110010001010110011010
00001111010000000010100000000100010001100010001011010011000010001000100010010000000111000000010001011
10000100000000000000011011011000001001010100000000011010000000000000010000000001111101010101100110001
00100100110000000010000010101000010010000001011000110000111000011010001100010010011101000010010000001
11001000000001110011011000000000010010000000100011010000000000100101001101001100100110100100100001110
00110000100011000010001001011000000110010100000000100000110001111100100010000000100010010000000000001
01010010000000000100001100000000000000101010111000001000010110010001000000001000000000100001001100010
10011100110000101000011000000100011101000001010000000010100000010011011000000000001000100101000010101
11101110010111001001010000011111011000001000000000010000001000100101001100000101000011101100011000000
00001000001100101100000001110000110001101011000000000000000010110100000001000000000100000000000101000
00111001101000101110000100011101001011010000011101110101000000010111001111001001011010000000100000000
01000001100100000000010000111010100001010010000110001000000001000100000110100011010000001100000000000
00000001000000000010010100001001000001100010011000000100001001100000010100000001101010001001001000010
00001100100011000000000010100010011010000001000110010000001000101000010000000001010000010001010011100
11101000000001100100010011011101000011101110011001110010100101000010000101010001010000000010100010010
01101001001011001000000111011011000100100001100000000000101000100010001100010000000010010000010001001
00011000010010010011100001001000000100100000100010011010100100000000010010000101101001101000101010000
10001000010001010100001001001111010000011000000101100011011000010110000110100100000010111101110000010
10101010010000010000110101000100000001011001110010011000000000000001000111100001011000000000001110011
00100000010110010000000100100000010100010101001000000000100010001001000100000000100100000010011000100
00001011011000101000000001100011000010010100111010101001000000001000000100000110000110111000010010110
01001001110111000100000110010000100010110100100000100000100010000101100011100101001110101000000001001
10000000001010100000001010011001001011000010000001101001010010010100000000001101100000000001010010000
