17 73
60 84
00011000000100000100000101000100100010010110000000001011001000001101000000001010110010000101000010000
01001000010000100000110000011100000110010100000100010010111101110011001011001010000100100000010010000
00000110100101001011001100000010101000011010000011001101100000100000010000011100111011000011101101110
00110000011100110001001010000110000010001101101100001000111100000000001010000011010101110000000001100
01100111100111000010100000100100000100010000001100010000001010100010100011010110010000011000000010000
01001000010000011100011000000001000000110000000001011000000110001001110000001000000001010000111100100
00100001000000000110010010001110000000101000001000000001000000010001000000001011000001000110001010000
10000000101011000010001110010001000000001100000000000000101010100110100000001001100010101000100100000
01000011101001001000000010010010111100000011000010010001100111000111111000010101001001000010000000101
10100000101100001100110010010000100000000111000000011001110101001000000001100010010000000100010000100
11010000001010000001010011000110010001010001010001000110011001001101000100001011010000101011010100011
00011011110000101000000000010010010001000110100010001100010100000000100101001110000010000001010010010
00100000010001010011100100010011000010101001000101100100001000000001001001000001010000101110000110100
00000000000000000001000010101100000001100100000100110100100011010010000000010000010001000001100000000
00100000110111001001010100001000010000011100001101000000000010011110001110000000010010100110010100100
01001001000000000010011100000000010001000000001000001000010111110000001000001001100010101011000110000
01110000011001101000000000000000000000000101100000101101001000000001000001010000000000000100001000101
00100001000101000000100000001000000001000000010101100010100001000100000000000001011010100110100010100
00010010000010110111010100000011000000000100001000010100001000010000011000011101110010100000011000000
00000000000000101000000111110100001100001011010000100001000010001001001100101000000000011111000101110
11100100000111000100000000100100001110000100000001001100001010000000000010001010000010000011000100110
00101000000000000010000000000110000001010011000001110101100000100100000001000010000010001100001101000
00100001000001010000001011110000001100110011110000000000000000100100010001010000001000000000000011010
00100011001000111100001101100010000000011000010000011000010000001010101001000100101010001001001110000
01011110000000000001100010100010000110001100000100000110100000010100001101011001010101000100100100001
10111000101000001100010100010001000010001100000001000100001110000100000000000100000101000100100100001
00100001100101011001010001010000001111000000011000101110001101000000010110000010000001001000000000001
01000001100011011000000010010100011000000000000001101011101100001000010010001100111000000000011000100
00101100000100000100101101010010010011000000000000001011001100001001110001000010100001000110011000100
01011100011000000000000000011101010000001001000100100101000010110100001010110110000000000000000000100
00100110000100101000001000100000001100000000100100000000000000101111010100000110110100000100000100000
01100000000000000010100011000001010100000101000000001001001010010000001001010010011000001010100001000
01010000000010111100000000101101110110000011010000010000100011000110110000000001000010101000000000000
11101000100001001011000100001000110001010010010010100111111000000000001000100000000011100000100010001
10001110000100001001001100100000010111010000100000100000001000110100000000000000100000100001110110000
00110000011010000100000110100001000100001000000001000110110000100010010100100100110000010001001011011
00000011000000000001000110101011000110001000101010010000000100111000100010101000010100000010010100010
10101001000100110010110001100010000001000000001100001111000010000000000000000000001010001010010010100
00010100110000100100000000100110110001001011000000000001000101010000010001000001001011000010011000010
00000000000000100000110000100101000100100000101010010010101001000000001000001111000010000000000001010
01010000000011001100011001110100000000000110000000000011101000001010000010000000100000100100011000011
00101010001100000100000000000001101010000000000101000000000110110110110100010101000000110011010000100
01011001010010010010100000001000000011100000001010110010011100001110101000100101001010100011100000010
00001000011000001000001000100010001000100101001000010011110101000000010000000000001110000010010000010
01011000000110111000001010101011011000001010110000100010100001111001100000010000010000001100011100011
00000000010100110001101100101000001100010011000000001000011100101100001100000000000001001000000010000
00000000001110100010000001000011010011000010010011001100011001101101000100101000010000010000110101010
10100000110001010000011000110000010000000000000010100001000000110011101011011000101000000110000001000
10110000000011100101100100011101000001010010001000111000001000001010000010000111001010100000100001110
00000000010010111000000010101000010000101101010000001101000001000010100101000110000010110110001010111
00001000000010100100100000000000000100000010111010000000100001011001001001000001100000010001001100100
10100010001100000001001000011000000101000101100000000000001001000011000000000000100100010000001000000
00010010010001000011000000100010000000000001011001001100000000001101010011101000000000000000000100000
00000000000111000100000010100001100000110000100010010010001000101010000110000100000101101000100000110
00000000000000100001001010111100000000110000001101000000001110010011110000101100101000001001010100011
10100101001001100010100100110000001010000000000000000000100000000110000111000000010000000000100000001
00000001011011010000010100000011100100000010100010000011010010001001100000110010000000000011010000000
00000100010001011000001110001000001010000000100001100000010000010100111000001010000001101010010010011
00101001110000001010000000000001101110010001101001010000000000010101010010000000000000100010000101000
00100000000111000000001000010001000000001001000000000101010001100000011000000001010100000001000101000
00001100010001000010000010100010100001001111010100100000100000100000000011101010100101000010100110010
01000001010100000101100000000000000110110010100110000001100010100001000001010000000010100001001010010
11001000011000001010001000001010100011110000100100011100000000001101001110011100010010100010111110000
00011111000000001000110100100100011001000000111101101100101010011010110010000010101100000101100001010
01110000000110000000000000011010000000101001110100101010111001001001001011100011000000000000000010110
01000001011100010000001001100000000010001110000110010100100101000110100001001001000000100000000011000
01010000010001000000101010000110001101000100001001001000110100100001000010001000010000100001100100001
01000000000011111100001111111000011111001101001010100000000100000000110000110000000011100000101010000
11100000000000001000100001000000100000000100101001010101000010010000000000000000100011000000000000001
00100011111100010000000101000100000010010000000010101000000101000001001101011000010000010000010101000
01001001000011000110000101000010100000000101000011011001000011000010000000000101011101100010000000001
00010010000100000000010000000000110000000100100010001101011100000000001100011010000000101100001001000
00101001001000110100000001000010001000001110001000001110010010100100000010001010000100101001110000000
00000000100111001111000000101000010001001000000000010011001100100000011100000110000001001001011010010
00110000111000000001011101001000100111000011110011000000010000101100000000011000000111000000001000010
01001100001000101000001000001010001010111000100000100001111000000000010100101000000100100100000000110
11100001101011000000100000000000000000000010010001000000000000110000000001000100101000100010000100100
00101010000100100110000100000100000001001100000001001010110000010000000000000000101111000100100010000
01011010001000000011101000111010110100000100100000000000000010000001101001001000011000100000100010000
00000000010001010011010110010001010001100100111100000100110000010000100000000001101010000010010011111
10010010010010101010001100100100011100100011010100001000000100010100001100100010011101000000101001000
00000011110100101110011010010101101001100000010100001010001001001000000111010000100010110011000001001
00000000001000000010001000001000101110100000001100100000110010000000000101101110100010001000010000110
00010000011100101010000001100100000000010000000011000011101000010010000110010011100001001000001101000
00000100100001010111110101010101010010010000100000011101000100000000000000000100101001110000001000110
00001101000000100001010100110010001100110100000011100000010000010000010000100000000000010110000000000
00001001000101001010001010001011001000100001101000001000001000010000000000000010001001010010000000010
00000100000001011100000100101101000100010100010001011000000000000000101000000010010010010010101010100
01100011110001000010000100000011010001011000000010000000000000011001100000100000000001001110000000001
10001100101100110110100100010100010010010000100000000000000000011000100000001011000001110000000100110
00001001100000011101000001101000111010000000010000000100000000100000000100000110000001001010010101110
10010101001010100010010100010000100110001101010010100000011101000000000101010100010001100000101010010
00101110100000110100011010111000010000100001100000110001001010001000100000100010000100001001100100000
00000000110001000010010111000100000000010010001000101101000111101100001010001000010000001011101100000
01000010100010010010101101000001010000011100010100011010001001010100101011011000010010000000000001010
00001110011110100000111000010000000000000000010100001100000001000001000001000000011010000000010011101
00000000000011000000001011000100000000000000101001001001110100101101000010011000010001000100001000010
10010110001100000000011001011000000000010000010000000100001000101010001011000010100000110001111000011
10110100000010110000000100100011000001010111001000010010000001000111000011100101010001001010101001100
00001101011000000000101100100011000100101010011000100000001000000000100010000000000001110110000010000
10110101100001000100000000000100001001000010100000110110100000000111000010100100000000010000010010110
