68 73
68 66
00010100000010100000001000011001001000001100000000110100100011000001000000110010000111010001100000100
00001001101001000010011000100000000000000010000100000000000100110101101100010100101001101101010001001
00000101100001000111000000011100101100000001000010100010101001000010000000100010011001000010100110010
01010110010100010101100100011000010001010110000110010000000110000100110100000010000001011100011010011
11010010010100111110001100010110000000000101101011000000100001010000110001010010001001000100101011010
00000100110001100000000100000110110011000010110100100100001010100000110001100010010001010010000010000
00010001011101110110110001001000001000110001100000010000010010101000011000100110110011000000100000110
00001101000000000100000010000111000010000011100000000000101011010110000011100100110001000010100100011
10000101001010011010000000000010101100011000001001000010110010001010101000000000000110010001000010000
00001001010100000100001000000110101011000010100100010011001000010110101001110010001100001000011010011
00100001111010001000000110010100010100001110011100101000010000000100110010110001101001000000000010010
10101100001010100001011001000000101000110110000000001001000000000011000011001111001000000000010001001
10001001000100010010011000000111110001011001101000010000001001000001000100110001100000000000011100100
00001001010111000110000001100011000110110101100010000100000000100101101100010000110010001000000010001
01100001010000001001010010100001000010001011001000000000010101000000100000010100000100101101000000001
00000000000100010111000000000011100001100001010100000000001010110001010011111100100100000010000010010
00110000001000100000010000001000000101001100110000000110100001000011100100000000111000110001000001001
00101010001000000001000101101001001010101010000011011010001001011010000010111110010000011101110001100
00000000001000011110110001000100100100100000000000000010000010001010000010011010010000001000000010110
11000000000110010010000000010010011011100010011100100100111000000001001010110000100000000000110111000
00100001000100001010000111011010000010001100001101001000100001001001110010000010001000101010001100000
10010001010010100001000100010110010000010000000010001010110100000010010100000010000000001111100000100
00010001000000000001110001001000100010100100000000000001010000001011000001000000101000101000000000001
00000100010001000000010010100000000010010010100001000000101100100010110010000101010111100100100101000
10010110010010000100001100000000110000000100101110000000001000010010000001001101010011000110000000001
10001001011100000000000100000100110100000010000100000100100000011011001101100011001011011101110101000
00000000001000001000001010110010001011010101100010001000000100001000110110000000100000010000000110000
00000101000001000000000101011101000010010100001011001111011010000000100000101010011010010101000100000
01100001000001100111010010000000101010000001000100100000000001010011101001100110000001011001000001010
00000000000001000010000100000100100110000000100010000010111100000000000000000001010000000100100100000
01010100100010000001000100000011000000001101010000111001010000000000110001010000000010000011001010110
10010010011100000100000101000000010011001001001010011100110000001100101100100100001000010000100001000
01010100000110001000010001001000011000001000110001000000000010000000010001000100000010101111000000110
00000010000010000000000000100100100001110110000001000100000000000100110000000110001010110000001011100
01100001100000010001001000000000000010000111010101001000001001000100100101101000000100000000000001100
11010110001100011110100000010000000110100000101101000100000000000101011000100000010011010000001001000
00010001100101011011000101110000001000000000000000000100010100000000000000000101110100010000101010011
10000101010000000000000001011000011010011000111101100100001000000101000011000110000001000000000100001
10001101011100110001101010001101110001000100100010000000000001011001000110100100100100000000100000000
01010000001110101000101111100000000010000010001100101001100000000011000001100000001100010000011000001
11000000010011110100100000001000000000011000000000000000100001100100000001000011001101001000100000110
00001001010000001001100100000000101100000000000101100000000000000000001000001010100000001000001100000
00000110000000100011000011000000100000000000000000000110010110111001100011111001001000100101000001101
00000001000001010000001001000000100010001100101000010111110100010000110001000001010010100100100000101
01000010001000100110001000000001110100000010001001100100000011001111000000000010000110100000110000100
00100100111010101000100000110000000010011011101000000110010001000000100000010001001000011110000000110
01110010011000000111100000000110010000100010010011000101000010011101010010110000010001000100010001000
01000000001000000000010001100111010000110001010001010110001001000000010000001000010101000101000100000
00001100000010001000100000000100000010000000000000000000010000010000000001101000001001010101111001011
10100000001000000010000010100101010100000010000010110000011100011000001010000100000000000100000001010
01000001011010000100010110011000010000001000010100010010000101000101000000000000110111001001000001000
00010011011000000000000100100110010100000100101000100110010010011000001000111100111100001011000000001
01000000000101000010001000000000010011110000010010101001100001010000100011010001001000000000000110010
00010100001101011010100000010001010101000000100100000101100110000010010010100100010000001110001001000
10100001000001000100000111001000001001101000000000000010100001001110101100100100000001010000011001000
00101010001010011000101011100100010011011100101001001100001001001001000110011001101000000100000000000
00010001001001010110101100100000100001000010000100110011001001001000100100001000000000000000001000001
01001110010000000100100101110011101111011000011010000000000000000100011100000000100000000100011000001
10100000011011101000011010001010000000000010110000001000000000101101100000000011000101000101010000000
01000001000011000001000000001010100111100100110000000101110000001001011101010000000000000010000001100
00000011010000000101100100001001010001000101100000101000000000000000010010001011000000101101010000011
10000000100110100000001010001010001100001101000000000111000101010100100100010110001010110010100001000
00000000010110001001000001101000011000000000100100000100100000100001000000001110001111010011100000011
10000001000000010000100010100001101000001000000001000000101001001001101011100001000101100000010000100
00011000110001100010000000000000001011100001101010001000101010000100000000100100000000000000001010010
00010100100001000000101000001000001111110100001110100010010011000100000111111011011000101010000110000
00111010100001110000011110110010000000000010100101101010000000101000001011010001001100000001101100001
10101010001010011111010011100000101000010010000000000100010000000100011010010000110001010000100000101
01000100100010000000100110110000010001110100000100000010000011000100000000010000100001101000100011010
01000101101101100101100001100001001000000000001011110101101000100010000000001100001001000010000000010
11001010000000010000000000000101000011100000011000000000001110010011101000100000100100001010001010100
00000000000011000000001010010011100010001001100010110010000001000111000100000110000000000100000000100
00001101000000110010010000011010000101000000000000001111001001010100000000001010001100000000110000011
10001001100001000000101000010000000000000100000000011000000100001010100000100001010100101001010001100
10000100000000000100001010000001000010100011000000010010101001000100100001000010000100000100000011000
11001000000000000100000001001010010011001101001110001000001000111000100100100000010001101000110000111
01101000000010100001010100010000000011001000000101000111100000100110010010000000101111011000111001110
10101101000010001010100110100010010000001010000010101100001000011000100000100000010011011000001011000
10010001111000000100000000100101001000011000100001001001000011000001000010000000111100000001000110100
01100011000001001010000000010100100000101101010000100010000001110101000000001101100010000000000001000
00001000110011001110010100100001100000001010100110111000111101001000110101110000001000001100000000100
10100001100000101000000000000000010011000010100100000000010101010001100000000001001001001001000000010
11100000010011010011101000000001010100001101001111000011010000100001010010000010001001010010000000000
00110000001001101000100100000011000110010000111000000010001100001001010000010001111000100110100010100
00010001100000100110011000110000100001000000000000110110000101000000101101001010000000000001011000010
11100100001011010101000010000100000001100100001100010111000000100001000010000001011001000001100111010
00000010010000110011001010010000001110100001000111000001000010110100100101010110010101001001000000110
01000100000100100000111011011100001001011000011011001100000100001000110010000100010001000100000000100
00000000101011000001101000100000000001010010000000001110110001001010000000000000000011011000010101000
00001001000101000000010110000001010100000010001000100000001010000001000000100101010000000101000101001
10100000000100101110000110000001010001000000000111101100000000001000111001010001000010011001000011001
01000111100001000000010000010111000000111111100101100010000000011000000110100001010000000000000000000
01100000001010111000100000000010100101010000011010000001000010010100001011010000010000110001011100101
11001111010000100010000010100010001101010101000110100100000000010010000000011100010010000100010001001
00001011000001100010001000000010010111000100000000001101000000010001100000100100001000011010001101000
00010101001000001010010000011110000000010010010101000110011000000010100000000010100000110101000010110
00110000011100000100110011001011010100000100010011100010000001000001010100000011000011101010100001010
01110001000101010000000100100000010001010000001000000010110101111000110001011101000010100010000000101
00000001101000001011001100000100100101001010100000000101100001110000010001001000101100100100001010010
10000110000011100010000001010100000101000000000000010000011110001110010110000010001001010000100100001
01101000000000110001100001101100000010100000011010000110101010000001010101000100100010000010010110010
