39 73
71 40
11000010001000001000010000101010000101001000100000000010000001001101001010000100100101000010000001001
00000010110001001001100010011000001000010000000000010101000110000001000100011110100000101001001000001
11100010101001010100100000001000010011011000101011001000000001010000000000001000010100000000010100000
01001110010100101010100100010101110100001110000010110000000101110001001011110100101001100001000001000
10011011000100000010000000010010100001001000111100000000000000100110101110110000100100001010100101000
11110100000000100100001011001001010000011000001010100000001101001000011000011000010001000000001001000
00000100110011001001000010111000100100000001000000001000000010110100001001010010010001101100100100100
00010000001001000000000100010000000000100100110000100100000000111000100000001000010101010010100100010
11011010011000100011000000000000100110001010000110010000100001000000111100000110000011001000011000010
00000011001100110100000000000111010101100100101101000100010011111001011000110000010010100000000100000
10101001011001010111010000001001001110011100010100011001100000000000000000011000010001000011101000011
01000100000000010001000110001010000000000100000000000000010000101000100110001100000011010100001000010
10110000000001010000100001100011001101000100100001100000001100010011010100110001100100010010010001010
00000100001110010100110000010011100001001100100100000100110000110100010011100010000100011101000000001
00000001101000101010101000001010110000000100000000011100000000001010101010100000101010100100001111100
00110010010100001100000001000001000000010100000000000000000000000001000001100000000101000010000001101
11010110011100000111101101001111000010000110100000100100100001110000011110000110100101100100100000000
00000101100000101011011000001001000011110110000001100000000011000000010101000100000001110000000000011
01000010100010010000000100100000000101001000001011010010001001101000010100111000000101010101011101010
00100010000100010000011110000000100110101010101000000100000000000010010001000000000000000010000000000
00000100010000010000100010011010000010010000000100000011000000000010000011010001000000011000000110000
10000100000000010101000100010010000100010011011100101010010000001101011000000001000000001100000000000
00110101000001000000110101001001100010001000000000000111100000000010010010001001100000000101000100001
00010100000001001010101001000000000110000010101000100000110100001000100000000100011011001110110001100
00011010100001100001001010010010101011000000001001000000000000000000101100111011001000000000000100000
10101100000000000100000100001010000000111000100001000100000010000010011001010000101010000100100100000
00010000011100001010000000001000100000010000010001100000110000111100000000001000000000100001010000010
00010000100010000001001000101000000001010100010001010101000010100000111001000001000100001011000000000
10100010001010001101000110000000000000010100011010101000010001100011010000100001000100111000001100101
00100000000000100111011101010001110000001001010101001101000000000111001010110101000001010000000100100
10000011001000100001100010000000000100101110100101100100000001000000100000001100010010000000000100110
10100101000000011000001100011000101011000101100001010000000000001111110100101010010011000011010001011
10000011000100010100100011000011101101001010101001110000100010000011000100000110000000100001100110000
00100001111000011011000010000001000010100101000101011000010011010001000010101000100010010010000110100
00010100000011110000000010011000000001010011001001100110011000100100100000011000010101101000001001010
00000001000001100000100010100001100100000000010001110010000100001100000110001100000110000001000100001
10010000001000011001000010011001100110000111101100000001100000000000001010000000000010000000101000000
00100000001000000001001001000001000100000000000001101101100110101101000000000000001000110110010000100
01110100100011100001010000000100011100100000001100000100000011011000000001001000001100000110000111000
11000110011000100100000001100101000010010100010110101000010100110110101000010101101100000010010101001
00010000000110001001000010000110010000100011000000100001110010000000110010110100100110100000000110000
11011000000001101100000001000100000000001000100110100000000001110000000010010011000111000000010011101
01000000000000100001100000001010010000010110000010000000000001000001011101100001001100100000010110010
01011000000000001101100101110001000011100101101110000000101000010000000010110001111000000010010100100
00101110101000110111001101110001011011010000000011101110001010100101001100111000000000010001011010010
00110101101110000001001110010000100110001000010000001000001010000000001011000100001000011001101000100
10001100001010000001010000010000000100000010000100010110100100010001000000100100000101000010000001000
00010100000110000000100010000000100100000001000010001000010010000110000101010000001100011110000010001
11001000011011000001100010001110011000100110000010010001011101000010100000000011001010001010010010001
00011000101101001001001000010010000010000000000110100100000011000101100011100000100001011100000010111
01000100001100000000101000100001010101011010000100110100000000100100000010000000001100000101000000000
10001100100000100000001101010110011010001100100000100000011001001000000101000000000010111010100101100
00000010100000001000001001000101000101001000010100110010000101001101001110100110011100010010001000000
11100001000010101100000100001010001100000010010001110011010101000000000000011100001000101000000101010
00100010000000010100000010010010100000000101000011000000000101001100000100000000010110001000010010110
10110001010010001010010000000100100000000010001100010000000000100001011110100110010100010100010000000
01100001000011011100010000000001000000110100001110001010100000010100101010000000000000011000110001000
01101010100100100000100100000000000010000101100010110000101110001000000000100011100100010010010010001
10000100100000000100011000000110101100000000000001011001000000000000010000000110110110000010000111001
00101000100000001110011001000011001000000000000100000100100000011000000000010000001100001000000000010
00111000000010000000000001001101110000001001000000000010001010000001001001111101000100000000111000110
01010010001001011000101000100110000010100101110110110001101000000000010110100010000000011010011001110
00110000001000100000100000010100100110101000001010001000110100000010110010101010001000101100101000000
10010111000010011000000100100001001111001000000110000000010001001010100000111011001100001000011010110
01001001110111000101100010010010010000101100010110000001000000001100001100000010010000000010011000000
01000010010100110000001011101101111110010100000101100100100100100000001000010100110001110010000000010
00101101000100000000010000001100000000000000010011000010010011010000101010001011000011010000010001000
00100000100000010001110000101000100001010100010000000000000010000100100101111000000001101100000111000
00110100000000000110000010001101000001110001011000010000000010001001100010000100011111000001000001010
10000011001001100010011000001000001001100000001101000100011000001010000000001010001110101100100010000
00100100001000001000000010001010000000010010011010011100011100011011010011001011010011001000100101000
00000001100100000000100101101000010110100001000000100111010001100000101110000011000010000100110100010
01010000001010000100110110010110100000100100100011001001110100010000001010000000111100000100010010000
01100111000000000010000000001000110000100001001001001001000110000110000101000000010111000000101100000
01000001000000010110011010000000000010110000001101000001110000000011100011100010001000001000010011001
00010000000010101100000100101001010010100111100000111000110110000100000000010000100100110000001010000
10100000000101000010000010101000101110010000100100000100110001001001011111000101000100000010101101100
10100010000000001100011001000001111100010100000010101001001000000000110101100000100001010100000100011
10100000001000010000100100001000000011001101100001010100001000000101001001010011111001010110101011010
01100100000000100100000110010001010000000111000010100000000100000100010001011000001110100000010000100
00110000110001000001000001100000001011100011001100000100010111011011010100110000010010001011000000000
10000000011000010110000010000001000000100000011000000001100000010000000111000010000001000110000001101
11110000000001100100100000000000001010100000001010000000010000011011100000001001000001010000001100110
00110100000110000100000101100001000000001010110010010010000100000101000110110000100000000100000101101
00100100010110010100000100010100000010101101000010001001000000110001100110000001010000010000110010100
00110011110000011010000100000010000000001011000001001110000000011000001000100000011010000000001100110
01110110000001010100001000100001000010010100011000000010100000010000101000100010001001101001101001000
01001010111100110110110000000110000100100010100111010101000000010001000001001100001101010110001000000
10010010010000000000000110001001100001100001000001100010010010000100000011000000111000000100000100110
00011010001110010000100000011010000010001000100011000000010010000110000000010000010001010010000110110
01000101000101110000011011000000011001010011000001010110001100010100001010010001000011000010110000000
00010001011010001100000101000010100000001011000100101011000010010110000001100110001010000001100000000
00001000111000000000011000111000100011001000000010100011101100010100010010101100001001001101100101010
01001110100100110000111010000010000001110010100000000000010000000000010100000000000100000010110000100
01101011100010000100101010001000110110100011000000000100000000001010110000001100111101000010001000000
10010010100100111000000000000000001010000000000100011001010011001010100000101000001010101110000000100
11110110100000110110100000000001100011100101000010101000001010110101000000000010001011000010001000001
01001000100010100000000000010001000001101111001101000010000111010000110011000000000100111000100000000
00010000100011011000001110100001100011011000010100000100011001101110010100010000000000100010110000000
01000000000110101100010000010000100000000010001000000110100110110110000010000000000110011100110011001
01111010100000000010011000000000000111011001000111000001000000100001111110101000110000000111000101000
