5 64
52 19
01100101100000000100101100110100000100000010100010000000000100100000001100000110000101010000110010010
10000100000011011100001001010000111100001100001101010100000011010001011000101110000011010000000010001
01000000100001100100001000000000000110000110000111010001001011010000100000111000100000010100000011000
00110100111000010101101000000110000100010000000000000001100100101100000010010000001000100100000000011
01000100000000000101000011011010000001101110011100000100000110111010011000010100000100101001011100000
10010000100001100101001000101000100100010000000001100000010000100001101000100000000110111000001000110
00000001000001000001110001011000000100010001000000010011010000001100101100101110010101010001100000000
01001011010000110010111000010010000100001110010001001111000000100010101010010000010010101100000010001
01110101100000101000101000000100100101010010111001101100000000000100011000000101100110000010000101100
00101010010100010010111011001011000111011000000000011000011100100101010100000000001011001000100111000
00010101000100011001011011000001000001000100001110011000000010100001000010010101000100010100100100010
10010000011001010011011000000000000010000100001111000000010000001010100100001101001100000010010010100
01000000000010011110011000000110000100100001011001000101110100100001010000010000001010100110100100000
10111100100110000100000111111010000100000000001001100010100110000100000010101010000000110010000000100
00011001100010000001001001000101000010110011000110010100000000010100001110001110001110110101000010001
01000000100000101000000011000000111010000101100010111111010000001011001011100100011001010011110000000
01010101100010001101000100000000010001001110010010100000010100001000000100100001000001110000000010000
10111011000010100001000010000000010100001000100000001101100000000100000110011101000010100000101000000
01000000011000110001011001001000001000000000001000000000110010111100100000000001000110100101001110010
10100010000010011011010110000000000000000000111000100101000010000010001000000100010110001100000000000
01000001001000010010000000100111000000001001000101000100000000011000000100100110000000000100000010001
01011001000000000100001100101000000100000001001100010000100111001011001100001100000100100000101011000
00000100011100000010010000000010110001000000011001000000001110001000110000110000100101000100101100000
00001001000000100001000100001001000110100110110000001001001001010000100010100000101000100101000000010
00100001011000000101010101110100001100001101001100011011001010000110101000101000010110000010000100010
00101001000000000000000000011001010001100001010000110101101001010110100001000001100110101010010100100
10000001001000101101001000100101010010101000001000101011100010010101100000000100110100010101110100001
01001001100100000001000100010100100001100000000110001110011100101000000001011001000010000000000000000
01100010110001001100011110001110000010100100110100000010001101000000000100001000000001010110000111100
00100111001001000100110000000011000010100010101000000001000110101100100110000010000000000010000000001
00011001000100011000000000101001110110000000001100000000010000100100100001000011111100000001000100001
10100001010110100000001110000001001100100000000101100101000100100000000000000110001101010010010001100
00110001010010000010000000011010000001010110100001110010011000000000001000000100101011111000011000000
10110001001100000010001100100000000001100010001000000110101100100000001000101000000010000110111101000
01000110001000100100010011010000010000000101100110000010000011000100101000000100001010001001000000010
00100010100100000000101010101000000101110011010011000010011010000000000100000000000010000100011000001
00111101010000001110010000100000010101001100000000010000111000001000100010001111000000000100010001100
00011001000000001000000010001000100100100000000111100000101001001000010100100001000000011000100111010
00101000110100001101000010000100000000001010010100011100000001000100100000010000100000000101010001100
10000010000000100000000101111000000100011000010001101000010000010100000101000000001010000010001101100
00110001010001010010000010000100110011110000001000001010100001100101110000000000110101000000100000010
00000000000000011100000010101101010101010000110010010001111110101000010110000000001001000000100000010
11010000100010100000000101000001011001011010001001101010001101000000000001010100000000101011101010011
00000100000000001110001100000110001000011000001000001000000010101100100000110000100001000000000001000
00000000000000001000010011000000011010001110110010100100000001000000110000000110001001101101001110110
01101000001011010010101100110001001000010101100000010011110101000000100001010010000011000100000010010
00000000001010000011101010001000000001100101010001000000011000000000000100010001110000100100000010010
00000010101100000011000000100000000000100011010001111000001000011000000001100100000100100100010001000
00010010100000000010001001001100000000001000000000100010000110100010001010000000101000000101010000000
10010100101010000000010110100101010000001010000100101001010011010000100000001001000000010010101101100
01001000000010011000000010010010001000000000000101100011100110100000000010100000000101001010001000110
11100000001000010100010011000001111000100010000100000100000101110100000000110000001000000001000010001
10000010011010000000000101100110001000011110011010000001010001000001000100001001000000001000100000010
10001010010101010000110010100001000001100110000000100010000011000110000000111100000010111000000001010
01001010011010000010000100000000000000100100000100100000010001000110000010000000000001010001001100000
01000101000101101000001000000000110000001110010000000000110100010001001110111100000100001110010001110
10111001111100100011010001000001001000100000000000001000000000100100100010000000000100000000011010100
00110011000000100101110010000000100011100100110101000001011000000001011100100100000001000011100000100
01000010101001010010100100001100000000010110000110110010110000000000100000000101000010001000111001000
01100000100000001111011010001110001100000001100000010011001000000011010011010000010100010001001111010
11101110111001001001010010110000001100101101100100001010110101010001100000010010000100001100000000000
00010000101100110010000010010001100000100010110000011000000100000101000001000001110000001000010101000
00101010110101010000000000001000011000000001000001110101001110000000001001100011000000001010110001100
11000111010100010110000000111110110000000010000010101100000011000000000100011000110000000000111001000
00001000000001001001100011010000001000110011110001100000110001000100010001100000010101100110101000000
01000100100111000000101001100010000001000010010000110010000011100000101011000001111000000100000000100
10001010010000000001000010001100110000000100001001010100001000000010110010001010000000101001001010010
00000001100000000100000101100000010000001000100100100010000000001001000111010101101110000110101101000
10000000001000000010110110110001000111100010010100000001010001010000001100001000110001000011100000010
00000000100001100101001000000000110010010100001011001000000011101100000110100100000010000001101000000
11100010000001000011000000001001000100000000011110000000001000000110001100100000011100000100000000100
11001001000000010000000001000000100100001100000000100001000110000001100111000110001010000100001110100
00100010110010100000100000110000001000000110000000010000001011000000000110010001110101001001101000000
10000001011000100010000010110110000001010000000010001000011001000001010001000001100000000101011001001
00000110001000001000000100011001010000000000110010000000001000110000100101101101000001001010010001010
10010111000000000000100000110000110100100011001101000000010000100001010011001000000000110010010001000
00101100000011000000000100001000110100100001101010000000001000110100100000111010000000000000100000010
01100100010100000110010000001000000110010000100000000101000110001001001010010010000001001011000010001
00011100001001000000000100000001000010010001100010000101001101100011010110011010110001010000000000100
10000001100100010100001000011010001001000000010101000001010000000000100101010010010000000011001101011
00100100001100011000001001000100011011001001001101011100101001000000000001000001000010100100000010010
00000000000000101010110000010001001100001101111100000011001110000101000001001010000000010001000000111
11100001100110000010111000100110000100000000000000010000010100011001110010000100000000000001010000000
10000001010010010000100110001001000001000001110001001000001000010100100011101100110110000011000011000
11000000001101100010000001010010100000100000000000000011001001001011110000001100101000110000000000000
00010100010000000010100001010001110011101001000110100010001000100011000000110110010101010111001100110
00001000000001010011001100001000000011100000001010000000101101001000111010110000001100100010001000000
10000100110000000101100010000101001000100010001010000010000001010010000110001001010101000100000100100
10011010000000011100000101101000010101000000000001010000000110001100111010110000110101000001100000100
10101010000000000101110111010100001000010100010101000101001010001001100001000001001001010000000000010
10101000011000110100001110110000101100110001100000011010000000100010001110011000000000010001010000000
11101100100000001010010001010010100010001000000000100000101011010001010000000001000000000101001000100
01010010101101100000001011100101000001000001000000001111010110100000000000001010001010010010110010001
00100010011000100001101100101011001000101001010101100100100000010000000101100110000101111001010000100
01000000111000000000010001000000000001000110000000010000111111001100011000000001011000000100101100000
11000000001010011100000000110000101101100000001000001100000101000001100101100001000010101100000110010
00101001100100010001000000101100101000000000000000110011011001010010000000011000011000000101001011000
00000100101000000011100010000000000010001010000010000000011000000001000000001001111001010101000011000
00001000000000010100111000100100000110100000000001110000100001000011010000010000000000000001010100000
00100000100100000000000110001000010000100001000000010010100010100011000110010010000101000110000000010
00000000100010000110010000011010010000011100000101000010010110001000000000010010000010010011000001001
