88 2
62 87
00000001010011010010011000101001000000000010101010101000100000100001010000100101010000100000000000010
00000101100100000000000100010011010000010011000000000000000111000000101010101100001100000001100100010
00100010010010001100001000011000100010000100000000000011101000000010110001010000000111000011000000100
01000101001001010001000000110000000000100000000101100010101110000010000000001110011000000000101110010
10101100000100001100010001000000100000000000001101010010000000000101100000010111100100110000001000110
10000000010000000010001000010100100110010010000000111010000000111000000001101000001000010100011010001
01000011000000000000011110010000100000000101001001000000101000011000100010110010100110010000001010010
00000010010000010010100000000000101011010110010001000000100001010000100010110100100010000000001100110
01001000000000000001000001000100001010010101010001000000101000001010110010110000101100101000010100001
00000100000110000010011000101100001011111110010000001000000000000001000010000110000011100010000000000
00000111010000100000110000100001100010000011100100001000001000001000000101001100111000101001000100000
10101000100101010000000000100000000010100000000000000010011010011010011000000001100101110000001010000
00000100000010001101000010000000010001000111000000010010001011011000000000000000000001000000000000001
00010100110010101011000000001101001101001010101000000110000100011100001101100100000000000100010010010
10100011000010100000100010000000010010000000100010100010101000000000001001000001010001101000010101001
00000100101001010000110000110000001010000100010100011010000100000111010100100001000101110011000000110
00000000001000010000110000001010000000010100011100110000100010000100001111000001100010010100101100010
00010011011000001100101000101001010101100111000010110011000100010000011011101001011110100100000000000
00000000000000001000000010000011001000100001000001000101000100000011000000001001100000000101000000000
00010000001000010000100011000100000001000011010010100110000000001111010100000000100100000001000101001
00010000010100000101010100000110110000000010100000000000001010001001100111000001000101110101010010000
11010000001000000000001001000110000010000100000010000000010001001000100100010000101000000011001000011
00100110000000111110000111010000010011000000010010000011000000000011000011000001000000000101110010000
00001001001001100000000100010010001101000100001110110100100000000010000000010101000100001101001100011
00000100000011110000010100001000000000111010010000100001001001110000001010011100001000001100010100010
01001010110000000100010010011110000100010110100001000010101000000101101110000001100110011000011011000
10001011000100110001000011000010001010001000000011101100000001000011000000010000100100000010000000000
00000101010000100000000100000000101010000101101010001111000110110000000001001010000010001001000000000
10110000011000010001010100100110001101010010101101000001000000010000101000000000000100100101101000000
10000011000010001010001001100110101000000100010000001000100011000000100000001100010000110110000001011
00100000000101000011010011000100000011001000000000001000000001101000000000001000100101000101001001010
10000000000000100110100000100111000100001001010000110100000010011000101000000100000100100010000000000
00011000000101000000000000000001000000000010001010011001011000010000001000100001100110011011000100001
00000011000100010001011111001100000000001001010101000000001000111010000000001000000100000001000100010
00100110100010101000001111011000001010001100001000101100000100001000000010001000100110010000110000101
10010001010011101111000001001001010000000010010010001000001100101000000000000101011000000010101000000
10000000000010000000010000100000101000010000000001000011100100100100100100010001000100000000010000100
01000000010011011010010000110100010001111010010000010010000010000001010001001101100010111000110001010
01101000000101100001101010100001100000100011000000010100000001000100110000111000001000000010001100000
10001100100000000000000100000000100110100101000101000000100010000000110000000110000000100000000001000
10001100010101000001001100100100100000011101000010010000100000000000110001000000000010010001000000110
11001001100101101010000010000000001100010000000110100000001000001000011001110011101111110000110000001
01001100001000001110011000001110110101001001000010100011111000101100001010111001001000001011101000000
00100000000000110100000100100001011000010010010101000001010001000001101000000010100001000000100100001
01100010100000001001110101001100011001110110101100001000100101000000001000000001010000000101100000110
00001000011000000000100000101000100001011100100000000000010010000000000101000011000011000010000010000
01010101000000000110110000000100110001000000011001011011100000111000000000001000000000010000000001000
00000000011001111001001000100011100001000001000011000100100011000011010101100001000000101000101000010
10011000000000000110110101111001101100000000000110000010000000000011100010001010100101010001010011000
11001001010100000000010100000000000101001101100000000000110010010000000110011000111010100000000001010
01010000010101000010110100001000010000000101010011001001010010000001100110000001100111100010000001100
00010100100100000010000010000001001011010000000001011001000110010000000000100010011000011100000100001
00100000101100000100110001000011000000000011000010010000001001100100000111000010010000000000101000000
10011010000010000010001001100010010100001000001101101000010000011001000000100000011010000001000100000
00010101000110010000011000100000001000001001000000010000110000000000111000100000101100000000000111100
01000001010101010010110101000100000010001000110001011001010000010101100001000100000110010001000000110
00000000101000000010001000000011011000000100000101010000000101001100000010101010100000000010001000001
00001000000100001001001101100011001010000100001101100000101000000000000001100000101011110000000100010
00001011010000100011000110100100101010000011000000000010010101000000010010101010001110010000010001000
01001110000110000000000001010010011010001100110000100001100100110001010100101110011000000001000000110
00100000001010111010001110000010000001101000000001000001010100000000111011011000011110000111001000011
00001101001110010000010000000110111000100010000110101000011100110010000100000010000110010000100000000
11101011101000000000010000011010100000000010000110000000010011000001010101001000001101100100010000000
00001100010001000101100110001010000010000101100000000011100110010111000011011100010010100000101000000
00010001000010001000001000110000001000110100000001000010000000100100000000010100000100000001110101001
10010000010000011000000011100100010000000101000100010000000000101101100000001010000010000000000100000
00010110110001010100101111110011001100010000101110010000100000100001000000000000100000100011010011001
00010010000000000000001000011100110100111000010000100101000101101010100011000000000000010000000000010
10000001000001001000111000000001010000100010010100010101000001100001000100010110000000100011011000100
10110000100001000000000000100001100001101110010000100100000000100001010000001001011100100100010000011
10100011011010101011011010010000100100010010001110011001100100010000000000111010100011111011100011001
10000110000101000000100000000001001001010000000100000011000001100001100110000111001000000001010001000
00000000101010001011111011110001000100010000100110000110000000011101010010010001000000000000100111001
00011010011011001000001001001000000011000101000010101001000000100000000101100000100001001001001001000
10000101011001100010010000000000001000000100010001101000000010001000010010000100000010111000110010110
00010000000101011101011100000101010100000010100100000001000101000001110000001010100010000111001000010
00000100111000010010001001000000001011011000000010000000010010001000000010011010100000000010101000010
11001000100011000000000000000010011010001001000000010000010000000001001100000000010000000001001000000
01001100000000000101000100010000010101100000100100100111001010011010110000010110001000010000100000000
00110101000111001000010011000010101000001100000000001001000010011100010000000000000100100000110100100
10100000010000100010001100110100001100000100100001000100100000010011010000001100001000001100100001000
10101100000000000100001101000001000000110010011110010001010011100000010001100001000000000011100000100
00100100110011001010000000110101001001010001000001101010100000101101000100100101001000000001000000011
11001001001001000000000111100100000000010011000111001000000100110010001011000001000110110000100000011
01000001100000000001000010011001001010000100100000001010100011000011000000100100001001011011000000010
00001001101001011010110000000000100010000101010010100100100101011010000001000100000100101011100010010
10001011010010101001100100101001000100000110001000010100000000000000000001000011110101001010010000010
00111010010011000001000011000100010011001000110001000001100100110010000110101000001000010110000000000
01000100100001110000001001000000101001001000000111010000101110010110001000101110001000101000000111101
00100001101000000000110100100011011001101010001010110001101000000001111000000110101010100000010010000
00000100110100011100001010000000000100110000001011100001000010010010000001101011000011001100101100000
10000100011000100001101100010000100000101000100110110010010010101010000000100110000110000110101110001
01000000000000100011100011000000100000000001100000000101001000111000001101100011000011000011001000001
11100001000010010000011010110010000011010100100010010110010010100101010011010101000000000011001000010
10000000101000001100110101100000000000100001000010010000001000000011000000111111000110000001000000001
01000010101010000000101000010110100001000000100001001000100011001100010000000000000000000000000011010
00010000000000000010001100101000010000110000000110100110010000000100000101000000101000100111100010101
00011010000000001000100000001100000001100001001100010001000000110010000001110000000000100111100011101
01101101010000000011000100000110001001100001101100000010000001000000010001000001000000010000011010010
00000010000010010011010001110000100000010000101100001110100010000100010011010001001100100000010011011
00001000011000000100001010000100100100000000101000100000010101001001010001001010110000010100000000001
