99 74
14 19
01000100011010101011000000000000100001010000010000010000000110000001001010000001000010000000010010110
00100000000101001101000000010001110010000110110000100001000110000101000100001010000010001010010000000
00101010001000010010000000010011000010100101000000000111000000010010000000000010000100001000111101000
00000000010010000000000000100000001010110000010010011110000000010011011001001111001010001001101010100
00100001000110001011011010010010001000000101000110010000001011110001000110100101000100001000001001001
00010010000011100110101001000010100000000000100001000110101000110000001000010100000100010010100000100
00000001101000010001110000000000000100110010000001010001100011001000101001001000001000110010000101100
00010010100010010101001000000001010000000101010001000001001100000001100100100100110101000000110001100
00100000000001111001011001010010000000100100110010011000000100110111000001011100010000011001000001010
01001101101000000010100100000000010001000111010000110010001000111010100100010001001000100001010000101
01000101010110100100000100101010010111100010100000010011010011000000000100110001110001000010010101110
11011101010001000100101000000001001000000000100100100000000000000100000010000001010000000100000001001
00010000000001000010101001010000001001000100000001000001011001101010001000000001110001100001110010000
10100000010000010000001100100000000011001010000000000001110100000000000101011000101000010110011100101
00010100000100101000010110100011000101011000000000001001010110110000010000010010011000100101011000101
00010001000100110000111100010001011110010000000101100010001001100100100001001100000001000000101100101
01100111100000101101000101100000100001000101001000001100000100010100000000011101100100000001101010100
00000000001101111000100000100001000100000110001000101101001000000000010000000011001011001000001000000
10000010011100000000100000000110001010100010010000001000001000010100000010100010001000000111001010000
00000100000010100010010000000001101100001001000101111000000100111000000000110010100011000000010000000
00001101111110110100000000000000000100000001110000100010010000000000010000011000000001001100010000000
00101000001011100100100010100000000101001000001011101100000001100110101111000000010100100000100011000
00000001101000100111001010100011100010010101001000100000110001000010011100000000101010010000000011000
00110011100100000010000000001000010001100100000100010110000000000110000000001000000111110010111100101
00100000001000001000000000000100000010100010000010010010100001100010000000100100001000000000010110011
10110000010100101010000101000000000010000010000101100101101000000100001101000000001100000000000110000
00011100011000000110010100100011100001111000001001000000000100000000000010000000010000001000010101010
00101010100010000000011000000100000000000000111000001000101001000010000000101101100100000111010100010
00001101100100101001101110001010010000100001011000001010010101110010000000001010000000000110000000000
00000110000011000001000011000010000101000000000001010000001001000001100110001000000100111000001011000
00000010100000001100001000000000010010000100100101101010000000100000000000010000000000011000111100101
00000000000010000010100000110101000100010111010100001111001000100000001100110100010000001001000000100
00000010101000001110100000000100000111101000001010000000010010010101100000100100010000000000000010010
00000010111011000000010010001010000000100000001000000000100000000001111110010000110000100001001111001
11110001000000011001001000001110001110000101101101101100000000110011001001000100001001100000001101001
00100000110101000010100100010001000100000100011000010001001000010100100011001110010110000011010010101
11100100101000000001000001001001001111010101000000101000010000100000000100000010011100000000000000011
01100110101000010000001101000100011000000000100100011010001000011101000000000010010100000100011000010
00001001000110111011000000100010001100000000011101100000110100000000011100100100000010000000101000000
00000010101110000010001110000001001001000000000000001010001110010011000001100000110011100000010000010
11000001001010101010000010011100000000000000011100101001100000110101000100000000001001000100010000010
00011111010000100000001000001000000010100000011001000101000001001010001100101000110001011000101100001
10000010001000110100011101110100000010110000110110001110111000000101101000001100100110011010000100100
00011000100010011001000001010000011010001000000000010000111000001000001001000001000000110000000001000
01010000000000010000110000110010001000001000010001100000100011000001100000000001010000000000010100000
00100011110010010000101000010100010101100001000100000010111110000000000101000010000001000010000100000
10010011000001010111000000000010100100100000011001000000001001100010100000100000010010101001000100001
00000010100000110000000110100010000000000000000000010100001000100010000001101000100100100000010010010
00010001110000000000000000000010100000010100010000001010000000001000000000101010010010010011000000101
00000000001001101000101010110010000010110000101100000000000011101000000100110000100000001101000010100
00000000000000000000110000110010010000010000000000000000001000001000010100110010000101100000110000000
10000100011100101000010011000101000000000000000000000100100100100101100011010010111000000011000000011
00001001000000101110000000010101000100001001001000000010010000000000010001100010011000011000000000000
10000000000010000000000000100111000100100001100100110000101101001000001010100001100001001011000010001
01101010101100001101100110100000110001000100000011000001000001110001001101100000100010000100000000000
10000010010001011100010001000000011000001010000010000000001000100010110000000100100000110110010111010
01011100001010000000000101100010111000100100100010000010001000001100100110010000000001100000110001101
10000000000000010011010011101001000000000011000101001000000110000111000001010100000100110000000100000
11010001100011000010011100100100011011000000000000001001111001000001000001001110000010000111100011010
01100011010000010001010100100100010000000101111001000101010100000001111001000001000001011000100001010
00000000010000100000001101110010011000000000101000100010000000000101100001011001010100000100000001100
11000010001011000001100010000000000100001000010001000111000000000100010101001000111100101000010001010
00001001000001001001000001000100110000100000000000000000000001011111011000000100000111001000001100000
01100000111000000000110011010101000001100000001100100100011011011000101111101000001100101000000010000
00000001111000101111010000001110110110000010001000100001001000000000000010000101100100011101100001100
10000100000011001100001100001000010000100010001110001000011000000000001101010010000000000010100101000
00000001100011000010000110101000010000101000001101000011100100000100110010000100000001010001001110110
00100000000110000000000000000000010101110011100000100100000001101000010011001001000100011101001000101
00100100010010000010100000010000000100000010000001110000000000110101000011100000101011100010101000000
11110001000000000000000101000000100100000010100000001010101011001010100100000100100011100100010101100
00010001010010010100101000100000000011101010100000010000001101110101010001010000001000001000000000100
00000010000000100001000000100001001110000101000000000001000010010010101000100011000000000100100000000
00000101000000010110010110100101000000001000000100110000001100000100001000001100110011010001011110110
01011010000011011010001101001000100011000000011100000101000000010000001010110001000100001000011100001
10110100000000010000000000000000101010010110011010000100010100011110011000000000010110010011100000000
01000110001010010011011101001001000110001001001011000010001100001000011111010101000000000000001000001
01100000000000010100001000010000000000000101010010001000100000001010110000010010000001000011000000000
00000000100100000001001001000001011000110000011000100110100010110001010100000010111011000011011001110
00000000011100100000010000000100100000010000000001000010000000110010000000000011001100011100001001100
10000000010111001110100110000000010000001101100010000010000010101000000000100100100010000000101000001
00000110100001011100010000001010100100001000110000101010010000101100000001000000100010000000100110000
10001101110000100100010100100000000000001001000011001010000010000010010011100010101011001000000110100
10011000010010000100000011100000110001000110100000100000010001101000001100110000010101001100100010001
00100001000000000100000100110101000000010010010100110010100100101000000001001000001100001001100001011
00000010011000101100001000010101000011101000000010010001101000000100000001000110001001001000000101000
00011110000000001110010111011010000000000000000100010010010001000000000001000000010100001000010000001
11100001010010011001000010110000010000100110000010100000010000000010000000001110000000110000000010010
01100100101101001010001011010000111010100000100011011000001000000011001000010100111111011100000100100
11000100001100000011110001011000000010011000100101100100100010001100000000000000100010001010100011010
11100010110001110000010000000000011000110100010010000000000100001000011100001000101000000101000000010
00000100011000000000010010000000010000001000001000000000010110000010100110000011010001110000000101011
00010000100001010100001000101100010000000001000000100001000110101000001010001100000010100000000001000
00000001001010101000000100111101010111010100010000111001010000100101011011000000010110110000010000100
00000101000000101100111101000100101010001000000001110100001100000000100100000000011011101101110001000
00100001000100100000010011001100001000000100000000000111010010000100011010100010010000110110010000100
01100110000000111001100000001000001000001000000010000110101001000010000000001001001000010000010000001
00100001000000001000000010010010000010010000000101010000000000001000000000000000010010000000000010001
00000110000100001001000010000101000111010000000000100001010000000010000001101010100100011011011000100
01010100100100101000101010110010000100000011011001000100001001100010000000101011000110111011000000111
00101100010001000100100001101100100101000000100010000011000101100010100001000000000010000010110100110
00010000100000000101000100010110000000000101011100110000001100000010010100000010100100000011010000010
