6 0
18 69
00001000100001001010011010010100000010100001010000101000100110000010001110000010000000001001110010011
00110010001101001001000010100000110111000100101000001000010100001000011000000001011000000000001010000
01000010000110001100000010000101011001011011100100101000010000100100110000010010000001000011011000111
00100010000001100000100000100001101000001100111010000000101011000000010100100100000000101000001000010
00000000000000110011010111100001101010010001000111000000000001100000010100000001000000000100110111010
00011010100000000010000101000000010011000110101001110100010000000110100000011100000001000100011101011
00110011010100000100100001000000001000010001000000000000001100000000000101001010000100100001001011001
00000000100100000000010000110010001000000000000101000110001101111010101010100010011001001001111010110
00000000110111000111000001010000000011000000011010110100000110011011000100000001000100001100110101000
00000011100100100011010001011100000000000010001000101000001000001000010100000001100010000100000000000
00000100010110100000010000010000100001010000001001000000000000000100100100000001000001011000001001000
00010000000010001000010010000010000001110110010000110010000010000000100000000011001101000110001000010
00110101100100010000001100100000000001100100000010010100100000011000010101110010101010100001100010101
00001110001001100100010000000011000000000000101001010100010000000010000100000101001001011000110100001
01101010010100000000010000001100000100000011011100010000100110110001000100000100100001111011010100100
00000000110011010100000000100000010000101100000001000000100110011010101100000000011100000000010100001
10001000000010001100001010011010010000011000011100010001000000001101010101010011100000000111001001110
00000010000000001001001100001000101000000010000011100000111100000101010001101011100000000100000001101
00001001010010000001011000000011010000000110001000000001000011001110101101000000100010001100000100011
00010100101000010101000010001101101000101011000110001000001100010000010001010101010101100000001001000
00011001001100001000000100001000001000010000000000100000000000000110100001001001000000001110100000101
01000010000110001100000000110000100010000000111000010010000001000000000110101110010000000000000100000
10010100001000100000000000000100111000101010000000110000100011011000001000001100010000010001000111010
10000101100100110010101000011010000100100010011010010100000100110001100010100010100100001110100010001
10100000000000110000000011101011001000100000101110110011000100011011010000000001011000000100100010000
00000100000011000000011000001100000000000010110101110000100100001100000100111000000100110000100010000
00011000010010100010000000001000001100011000001001000000010010111101000100110000001011000000000010100
10000000000101100000100001000010001000010000111110000000011000100010110001001001000000100000000100110
10000101010000111101111100000110011000000000000000000100010110100001001110000001010000000100101010110
01100000101011101000011000110001001000100100111010000000001011001010000101100001011000001011011000101
00101001001000000101100001010001000000101010100001001000100000111000000101001000011000010100000000010
00000100000000000000000101000010111001001101011001100101001000000001010000000011000001001001111000000
00010100000000100001000111101000110000101000000000000010100010000000011000111000000110000000000000010
10000100111000001010100010000000010000010010100010000100011000001010001000001100100001010011111000100
10000000101000001001010101111110010010101000011010001011010000001010010011001100000000111001010010110
01000000000000001010011001000010100100101110001001000110110000010011100000110101011100100101010000001
00000100101010101100101101001001000001000100000000110011010001101000000000000010100000011010001000000
11010001001100100110010000001001011000000001111001000000010010001000111011100110000100110000000110110
01010000000111001000000001000001110010010000010010101010001001001011100010100011001110010010110011000
01110001110110000010010010010110000011111011010001001000100011000001001001101000000000101100001010010
00100000100010000000000000101010010000000000001010110000001001101000001101100000000010111000000010011
00000010111110110110000000101101011001000010011101001101010000001000110010100011001000111000000110000
01000000010100100010000010100011100000111001000101100001000000100001011001001000010100001100011000010
00011001000010101100011110001000000000100000111000000100001001001100010001000000001010001011000100100
01000000000000010000000011100000000000000000000001000000001000100001010011001000000110001000000000101
00110100101100000000000010011000001000011000010011000110000001000100000101001100110010000000110000000
00000000000000000010101000000101000100000000000001001100001011000000001010000000101100110001010000000
00000000100010000010001000100000000101101010000010000010010010001000001000000000000100100011010000010
00010001000111000010010000000110010110000111010001001001001000001110110010101011000010000000110011000
00010001010100010010011011101001100000010000010101011100100010001010001001000000010001010110001001010
01111101010100000100110000010110000000000100000001110100001100010100111000000010001000011010000000110
00000000010011100000001100000110100000100010100100000001001101000000010000010000101000101101000001000
10010100000110001110000000000100010100110000100100010100000001010100000000000000000010010000100100110
01000101000110000000110100000000101100001100100001010000100000001101100000100000011010000110000000000
00100010001110010011001011010000101110000010010100000000100100000010101101001010101100100100100000000
10000100000010100010101110101100000011000010011111010100011100000001000010100001001100000010000001000
00001000110000010000001000000010010101000000010000000000001101000000000101111000000110001001001101111
00001000110001000011000010000100001100100100101110010001100110000000001000010110101010111001101111100
10000000010101001000000000000101100010000000010010001000101001000010000000000100000001000110001000110
00100000010110001100011000100000000100000100100000001000101000101010110000100100000010011001000100000
01010111000110100000000001010000000000100100000110001110100000000100010001000001000000000011000010100
01010000100110010000100010101000100101000100010100100011000110000000001100001100000101000110000010011
10100010001000101100110000101100101000001000001100100111000000000010010000011010100011001101111011100
01010000010000100101000100000001001000000010101010101000000000110000001010000110010001010000000010010
00001100010000001000010010010100010001001010001000001000010000100010001001000000000010000111010011101
01010110100011000000010000010000001000001101110001000101010000001001100000110010000001000100010110011
00010000001100000000000000010000110000000101010000000001001010011000010101010010101001000010000000100
00010100010001000100000110101111001101010110001110011100000010010001100000001110000000010101010000101
00100010001010010001000101011000000000100000000000100001100101011000000110100110001011000010000101000
01000000001011000001000100100001000000110000001110000001000000010000100000000000000100000100000000011
11000111000000001001110111010000100001010011000010000010010001100100100100010000011101000101000110100
00001110000000000000101101010001000001110110000000000000000010001010000010010000010000000000101000010
11010000000111100010010000001001000000011100100110000100010001000101000011010010101000100101101001001
00000100010010101011011000000000001000101000011011011100000001000110010100010100010001010000001000001
10101000100000000001110110000101000100000101001101000000000000001001101000000101100101000000000000010
10000011000010000101000000010001010001101010000011010000100000000000011000000110110000000100001100000
00100000000111000000001100011100010011010000000000010000000001000000101000000000000000010001111001001
01000000100000010001010001000000000001000100000001110001000001000000000100101000000100110001000010011
00000001001010011000000100010010000011001100101100100100000010000101011000011010110011000000110000000
00111000100110000101100100000011100000100110000000000101110000001010100000000001100000001110001110010
01111001011000011000011001000000000000010000101100001000100010110001000010000000000000000000000100110
01000100001010000000100000000001001100011100011010011100000100011001100100100001001000010000100010000
00110000000100100110101000010100110000000011111111000100000000000100000010000111101110010000000010100
00011010011000100001000000010101100000000111000001000000000000000011000110100110000100111111001001000
00110010100000010001000010010001010000011000100001100010000100010000110000001001011010000011000010010
01000000000000010000100010000000001000101100001000010110100000000001010100010100010100000000100010010
00100011000000010000110110000001000001110000000001100000011101000010110000001000000000110011001100010
00000010001011101011000101000100010010000101100100100011100001010000111000110010001010000101101010010
10001100000100000110010000001000010000010010100000010010001001000010001000000010000010000010010010010
00100000100000010000000001001000001100100000010001000001101000000001001101010101001010100001011001100
11001010100100110101101000000000000011001100100000100000001100011000000001000000000110010010100110101
00000100100010000110000100100111011100000010000000001000000000000010110010001011001000110011000101100
00000001000000100011000001011000000100010000110100000010001010001001000000001101000000101100100000110
00001001011000000000001100100111110001001110001000100110000001000010001010100100000000000001010000100
00100000000100001010100000000001100010000000010000011011010010010010111000010100001011000010001011100
00111000100001000010010001000001001000011011000001000110000000001100100001100010011000001000010000000
10000010100000100110000000100000100000010000010000000010001111001011110101011110010000000100001111001
00001010000000100000000010000110100000001101000111001110100100100110010001100010110100011000100000000
00110000100000000010000000101001000000100010000010010100000011000100010001000001010011000011100000100
01110000000000110101000000011010100010101101011010100000101100000001010010100100000101100010001110001
00000100100000110000100001010000000010000000000100011001010001111100000000000100111010110000000010000
