1 68
84 91
11001001000111000100000001001101010110000000011001000000000000000010011101110000101011010001100000010
00000000100001001010000010001010000100000001001001011010000110000000000010000000000101000100000000000
00010100100000101101111110001000100001000000001000010010010111000000000001100100101000000010010000011
00000001110000010010000001011110001000000000010000100001000100010101100000000011001001000101011001001
00011000000101001010000000100100100000001000011100100000000010010000010001000110000110000100010001100
10000001000000110000000001000110010101101000101100010010001000000100100000000000000000010111000000100
01010110000000000101000000000000000100000111000101101000000011100000101100010000001000000000110100000
10000011000111000111000001001010010110101010010000000000000010001000100001010000010001000000000000000
00000000000001100110000101010100000000000111000001000101100000000000100000000000000010000101001001100
00000000001001001010110011100100000000011000001110100001000000010000101010000100000100000010011000010
00010101100011001000110000101101000010100110001001000111001000110101001010010100001000001000101000100
00000001000111100000000000001100010001001010000000000001000100011100001000000100000001000000111000001
11000100110000101000000010110110100111101101001001000000101000011101110000101110010000010001101010100
00100001000110001011000010001100001010110100000010000000000000000010000000110011101000001010000101000
10010000110000011100101000100001000001100010110000100100000110010100001011000100000010001001110010101
00110000100000000100101011000010001101000010100010101110100001001110001000100000011010100100111111000
00000000011100000000010010000011110000001001101001100011100010010000010010101011000010000110100000000
01010001010010001000000010110000100000000000000000110100011000010110100000000011010101100000010010001
11000100110000011010010100010001000001000000011010000010001110001000000000000110100011000000001100100
01010000000110101010001000000001000000010011000110100111000010000010001010001001010000100000001000010
00000100000100000100001110000010011100100000000000001000000001110000000000101010100110000001100010000
00010001000000000100001000100000110100001100110000100100000000100001101000000010010000010001000010010
00000000101001011000000101100000101101000000110100000010111100100101000000000001000100001010000000010
00000001001001001101000000000000000011010000000100001001000101011010000001011100100001010011000000000
01001001001110010000000001101000000000000100001010001000100101101000000000001100010010101011000000000
00000100010010011000011010010000000100001001101101001000001000100000000001100000000001001000011001010
00010100010000000000000000011011110010000010100110010001011000000000001001000100101100000110000101100
00000010110001010110101000110000010100000001000010001001110000010001000100000110110000000000011100111
10100011100001000010110001000011000011110100000000010101101010010001001011000011010100001100000000000
00010101000100001000000001001000110001000000110000000010000000000000000100010101010000100000100000011
00101100010010110101001000000010000011000000001101101000001000100100000010000000110000000010101011010
01001001000000011100000011000000010000000000000000000010000001000100101010001000010010011011101000010
10000001000101000000000001110000010010100100000100011100010000110111001010101001100001000010110010000
00000100001101000000110010000000001000000000000000100000000000111001110001010111100000001000010010100
00010000001001010101010010000110100100010000101100000010000110100010110001100010010101111110010010011
10010010000010010010011100011000011010000000001000000000000000001000001100000100001011000000100100000
01100000101010100010001001000101100101000000001000001000010100110101000110010000111000011001000111010
01100000101000110100000011001000100001101100010100100000001000001000000010011000010000100010000000000
00000010101000001000111011110100001001011000000100000111000100101000000010100101001000100100010100010
00000010000101001001101010000011000001011000000100000000000001010010010010110001110000000010000000100
01011100101000111010101100000100000001000101010011000000011011110101101000000011001001010011010000101
10010000011000111001001000000001000000001001100010011001101000000010000110001100010000000010100010010
00000001000000100100000001001001001000010100000001000000010010001000110010010000000010000110110001110
00010011000100000100010001100000010110001110100010001010010101100100000010000000001000010000101001010
00000010000000100000110001111010011000001000010000010011000110011000100010010001110011101011010000111
10010100000000001010000001010001110000001110101101000001000101001010100100000010001010000000000010000
00001010000101101000001110011111010001011001010011101010110000111001011010000001101001000110000000000
00010100110000001000100100000011000010000101101010010011000001100000000100000000000010000010101011111
00000100000000000000010000001000001101000010000101001000001110000001010100010000100001001000000100001
10001000001000000010000100010110000000000000011001010000000001101010000001010100010001010100000000000
00101000000000101000010011001011011110000000001101010101110011000110110000100100001100010100001000001
10000101010000000000000010110010011000001010010000100100110001000100000010100000000000011000011010000
10000000010100100010000100010001001000000000001011000000000100100001001101101000000001001110000001001
01000001000000010001011000001101001000101101000100010010010100101100100110000010010010000001000010100
00011110110010001000100010110110110011000001000110101100000000100001001000000011000000000110010101000
01101000000011101100000000101000101110001010110100010100000000000100100110001000001000001010100110110
00000000011100101010100000101001001101000010101100100011001001001010000000010110010010100000000010001
00110100010101001000011010000110110000000001000000000000010010000000000000000010010001010000010000001
10100100000100010000010100000110101101010010100000000100010001101000111001010001100000101101101001000
00000000101000110100010000000100000101010010101011001101000101010001000000000110000100100010100010100
00100101010000011010000001001000000000000000100101000100001101001000101000010001110000100100000101001
01100000000100000100110000001001011000010000000011000010000010001100000001010001010010100000000110010
00000110101001001100101011110000001111001000100000110000000011000100010000000110001000110001000001111
00000001000101000101010000000101010000010000010010101000000001000100010000000000010000001000000001000
10000000000100111001000001001000010000000000001001001010000011000000110000000000101010100001100000010
01100010001000001001000111100001000000100101101110000100000000110000001000000000001100010001100000000
00011010010001001111100100000100010011100100000101010000110001100100000000010000101001000101011011100
00011000011100000000010010010011000000000000100000000000100000111100000010000010110000000010000110000
01110000101000100111000010000010001111000100010100000000001100000010001100111100111000011011011101100
00001110000000001011000000000110000010001110010001001001000001110001010101011101100111000010000011010
00001010010010000000100001000100100000000001010001101000000010010000001000100100110100000010110001010
01100000001000110101100001000001001011001010000011100111110000100000000001000000010000100110010000100
10001110000010000101000001000001100000001001001000011001010001010010111001000110000100011001000000010
00001000000110010010000010101100111101110101001001001000011100011100000000000100101010000100011000110
00000010000011100110111010100100010010010001001011011000000000010100100000110000010000001011001000001
01000000010100000000000000001000000000001000000010000000100110001010000010000110010101011001001011010
00001111010001000100001101000101000100100001001001001010000001110100000000000000010000100000000000000
01001011110010100100000110001001111010110011000001000100100000000001100000000110000111101101001000100
11100100011000000000011010000000000000001110000000101101111000011001000000000000000010011100001100000
00000010000000000100100110001001100000100010000100000000000000101000010010100100000001000100001000000
01000000010001110110100010011110001010000000100010000100000001101000100010000000010011100000110001001
00010100000100101001010000000110000010101100001110000100010011100111000010010000110010101010000010000
00000100111000011001000000100011101000000000001100101000010100100100000100011000001010000010000101010
11000011010000001000000100100000110000010010000010010000011010111011000010001000110101000001111011010
10000100010001100000000001000001000100000111101000100100101101000000101001000000011010000000000001100
01110000100100000100010000101001111000000000001010001011000000000010110010000101101000010110110100000
00000011101100100110000111100010001000000011000000000010000001000000000001010000010110000010110100101
11000010001010000101000100011001000001011100110010011100100000000001000000000000001010010101010010000
10001110000101100100110100101011001000000011001100001001010101111001100000010100000000110011100110001
00110000011000010000000010011101000000100000100100000001000100001000000000001001110000011010000000010
01110100100001000100000011110001001100000010010000001011000100001000100000001010110011101000011000011
00000000000010100010001001000010000001000000000010100000011000010110101001000010100000001100000001100
10110001000101001000010011000001000110010101000001100010001100011011100000110010110100000000000000100
00001010000000011000000100000010000000010000110101000010000001000011001000010001011101110110001101001
01011000001010010001010000000000110101000100000010000010000010100001010100011010000010110010000001100
01000110111101001011000110100000000100000100000101001101100110010000100010010110000101100100100110100
00100000000010101000000100010000010000001001000010000100010000100000010000010000100001110001000000000
00001000000011010100110001000100000000101000010011110000100000010101000011011000100010011000000000011
00001110100001000011100001000010010010011110010100000100000000000001100010101000000000010010000001110
00010000000111000000110001101100110010000110100111000001000001010010110010100101010010000001000010000
01000000000110000101001110000101000001010010010000011000000000001011001000011000000100010100100000000
