70 43
100 0
10000101101100010100001001100100011000000010010100000101000010000000101010000111010000000100110101001
00101101000100100100000000000010100110000000001000011000011100000000001100011000100100101000001000100
00100100100100000010010001011000100100001000100100000010100110001010100000000101100010110100001101001
00010110110001001000001001100010110000100001101001110110000000100110010111000001101010000001001000000
00110100100110010000001101000010000010001000011000000010100010001000101001110010010011001111000000000
10010001000101000001110000111010010110000000011010010111000101100000000001101000101010000001101000110
01000001000100100010001010010100110101000000011000011101000110111110000001010100010000000000100001001
00000000000000111100001101001001000000111011001111000001011111100001010001100100010000001000010010110
01010000000111000001000110010010110010000000001101101000010000110101000000000110011001111001010101000
00100010000001100000001110100000100000000000000011010000011000101100001011000000111101010100101011001
01000010110010001000000000000111000000000010000000010000010110010110011101000000000100011001000100110
01110000100100001001100111101000000101100000011010001001101000000000000100000000000110010010001100000
10010001000101001000001000010000001000000000100010000000100000001010010000100111001100000010100001110
00101000110010000001000000000101000000000010001100001000111001000001100100001100010010100010100001001
00011001000000000000010000000001000000000110110100100110100101000000010001101010010001010000000000110
00000000100010000000101000011010000001000010101000000101011101111000000010101101110100101011000100100
00010001100110000000000000000000000010010111000111010000010010100011001010000010100011010110000001000
00110000100110000101011100100110001010100100111011000101110011000000100100001010100110010000101010010
10010001000000001001000100000010101011100010001110100010000110001000000000100010010000100100011001001
00100001000010000001001000001100000100001100000000110000110100010000000000010000011010001100000100011
01001010001000100000000100010100000001000000000001000000001010000110001100100011000110000110000001010
10000000100010000110110000001010010000000010010000001000000100100000000100100100011100110010011101010
10011011010001111000100000001110110000000110010100001101001110000010001000000000000111000000000000010
00000011010000001000001001011000100000111101010100100110000011001000001010110000000000100000110100000
00011001000010100001000000001100000100000010000010110001001001010010000010000010001010100010011000000
01101100010100001000100001010000010100000011010000000001001101100000000000001000010010000001100110010
10000101000100000011011000110011000000101010001111000100000000100001000101000000100000000100001100000
10010100000000110110111000010000100000111000000001010000000001001100111111000110010010111011101100001
11000101000011101000100001001110001011010011001110100011001000000000000010001001000111000000000011000
00010010100010011011110000000100100011001100000101100000001101010101000111001110000000000101011000000
00000001011101100100000000111101101001100001000000100000011000000001000001000010000100001100001001000
11000010010010010000011000011001001001000100000001001101000100010101100010000001000100100010100010001
00110100010000000000100001010001000100100101000001100101101101001000010001000100001000111101100001100
10001100000100001000010110000000100000001011010000001100001110010000000100001000100110100001000000000
00010110000010111001000001000000101000000100010001000001011000001111011010010000001000110000100010001
11101010101000001010000100000001011000000001001010000000000100101011010010001001010110000010000000001
00101000011101100010100000001010100110010100000100011000001000010000100001100000001010011101100000010
10000001000010100000010101110010000001010010011000000000000100010011000000100000010010000101101000000
01101000000110111011000000000000000101000101000101100010000001011011001011101000100101100100111110001
00001000011100000100010010110000001010000001100101000000000000100111000100100001101010101010000101101
00100000010010000100100000101000001100000000010011001000011010001100000000100001010101000100100100000
11111000011001000010101011010000000100100011010000010101101011101010010000000000101000010011000010111
01001000100110000000100000001000000100000011101010001000100100000100110001010010000000001110111001010
00000010010010010011100100000010000010000000000100110000010000000000010000000001000000110101000110010
00100110101101100000100010110100001000001100000111001000100000010110010011100000000110000100101101101
00001000100010000010111110011100000000010100110000000100010010000001000001100010110011101100000000000
00000100011000001101110101101111011001000100000100111110010110000000010000010101000000001000000100000
10000101010100000111000110110000011100100110000000000001101000000110100000110110011000000000001010000
00000011100101110001001001011000000011010000110010000000000001100001010000001000010100010000000000000
10000010110010110000000010110000000000000000000110100000100100100111000000010000010000000010110101100
00000000010010001001010011101000001001001000000000000011000000000011000000000111001011000010001100010
10011101110000010011000100010001010000100011000010000100000010001001000010001100111010111000000001011
00101010001000000000111010100100101010100000100110000001100000100110110011010000101101101100100000000
01010101100100110001000000010010100000001000000000101001010110000000001001100100011010001010001000100
01000000101110100101100000000000000100100000000100000000100010000000001100010100000010001001001010000
10000000000000010000110111000011110000000000000000000000100110010010000110000000000010011101001000000
00001000000000000010000110010010001000000010001010100001001010010100000100101011000000000011100000000
11000011000100100010000001000100001010000001100111001001011001010100100100000100010100011010010000001
01000101001011000000011010100011100110100001000101000000000000010000001000000010100000000001010100100
01001110110100000100010101100001000111010101010010000010010011000000100000100011110000000100011001000
10001001000000010101100000001001100000000100110000001011100101001101101000000100000100000100001010000
00000011010100010000000101000110001110100101010001000001100000100100000110001010010000010100101000001
01000100001101001001101001001100011100001000000000010010001101011010111000100000111000011110000000101
00011001110001100000000100001001000000000000001010000001010010101111000000000110000000011000010010000
00010000110100100010000101000000011001101100100101110110010110001100000000010100001000000101010100010
10000010001000110001000110100100000000010010000000011000010000011000110011101100010001001011100000000
00010001100110010100000000101001001010010000100010010101001001100001001010000011010000001010000000100
00000100010000101010101000100001111100000000111001000101000001110000110101000000000010000000010000010
00001010000000100000100001011110010100000000000001000011001010001110010000000000100001000000001010100
10001000001000000000010000000000010000000001110110000000101100101101101000100001001001100111001000100
01001001000000011000010101000100100100000000000100000000010000001100111001001000100111010000110100000
00000001001111101100100001001011000111010000000000111110001010010100100100001010011000110101000111001
01100101111000000100000101000000000101000111110110100000000000000001011010101001010001101000010101000
01001000010011000010100000010001010000101101010000100110000101001001000010011100000000101010000001010
01011010011001100000001110000100001100001001101010000000000110110010100110000000101010100101000001010
00100110010010000010100001100000000000100000000010001010110101100001000000010000001110001010011000000
00001010000000001100101000010000001000100001100000101001000000010001110001001000000000001000001000100
01001001100001010000001100000011100000000000000000000000110100100000101011001001100100111101001000000
00000010010100000001100010001000000001000011001100110001010000001001100000110100010101000011010101000
11101001001010110001000010100010100000010100000110011000010000110010001000011000101010111100010100000
01010000110101100100000000000000010000000000000100001110011000000010010100001000010100000101100100010
00111010101000000001011110011000011100001101000000001010000100010011101101000000100100001110111000000
10101000010000100000011000011000101000000000000010010000000000000010011010000010011100001011001101000
00001010100001101000000110001011001011100001111010000010101000100100010101001001000011110000000111000
00101010100110110110011100100101011000100100000000111000011111010001000010010010100011000000001010000
00011000010010010001010000011100100101000000000000010100000000110010101110011000110010000000101000011
11100100000001100011011000000000000001100001000000010100010000000001100000100101010010010000000000011
00000100011010100100001000011000100110100110001001101001001000100000111100111000100000100001001000000
10000000010000001010010110000100010000000001001010001000100110100000100000001000000000100100010011000
10010000000111001100001001000010001010011000100110100100100010010010011001000000001100000000110010100
01111010000000000110010011000010010100010000001000001000000000100000101000000011100110101000000000110
01100000000001001100000010000010000010000000010000010001000010010101001000100000001101100000101000000
01000000011001010010100100000000110101000110100101100010101011001000010000110010000100010111011001000
10010001100000011000010000100100001010001110000111100000000100001000111010010000010100100001110110000
00000000100111001100011000000010010000111000000000010010001100000000000101110010100000100000010001011
00111110001000010100010011001010100011000100010000010111010110010010111000010010100001101001100101000
01001100010010000000100011000110000001001101100001000000001001111000010100011000000000100100100010101
10100101010000010100000010101100001100100100100000000000011000001000001000100100000000000001011000011
00010100100100010010010010000000100100101010010001110110000100010001001111011011000001000001001010010
00000101110000101000000010000100110011010100001000110000000010101000000100000111010011000000000000000
00111101001001001001001001000100000010000100100000000010000000000000100000001000101010000001000011000
