66 26
30 61
00010000101010000001000010100001001001011001101001101001000101100100000101000001010010101100000010010
00010001010000001000100010101100000100011000001000100111010000010000011001000001001110100111110101011
00100000000010000111001000100010100001000100101010100001000000010100000000000010010011101000100010100
00000000001010011100000010110000010101101010000010100000110110010111100110100000000110100000100001000
00000001101101000001010110000000100010000100000001011101000101010100001001100011100100000100101001100
11001001000100000100000000010000000010000101000001010001100101001000000000100000000110000010010011001
01010110000000001000000001000000000000100000010100011100000000010110001000010100000110100101101000001
11100010010000110001001000100110010001100000100001001100000100100100011000011010110000001101111001000
00001001000010001000001000100001010010001000100000110000000000101010000010000000100000000110000000110
00101100001000000110000100100010100010000101100000100000000001010000001000000000001001011010101001001
00011100001010000101001000100000000001010010101010010101001000100000001100010010101000000001001100001
00100110000111011000010110000000000110000110010010000100000100110011000100000100000100011111000001000
00001000100001110000001010000000001000101010000000100100001000000100100001010000100000010101010000010
00010101000110000000000000001100100100000001000001000001100011000011110110000000000000010011101000100
10000000000001000101110100011000001110101110000000000001000100101000010100100100010000010000000011001
00000000100100000110111000000100001000001000000000100100010000101001000100000000001100001000101101100
00100010000000001100000101000000101000010101000110101101001011010110110000111000000101000100000101000
01000100010010101000000110100000000100010100111010100010110000101000110000000000000000000101010000010
00101010000001000000000110000010010110011100000110000001000110001000000100100011100001010000100000100
01010000011010100010011100001111101010000000110001010001001001010010000110000010010100001011000000000
11000001001010000010010000010000001101000000011101001100111001101101000001100011001000000001010101000
00100110010011100001001001010000100011000000000100100100100000000100010110000100111000011011010111001
10001001010001100100010101000001000010001111000110011000000001100011001110001110000001011100000110001
01001100000100000100000000000010000010000000111000100000110000111000000010001000001011100100010001000
01000000100001010001010100100010110010000100101010000110001100100101000000000000110110101010000011000
11000000001100010000000110000100000110010101000100001000010000001100000100100011000011011000001000001
01001010000001000110000110000000000001000101001000100000000010001001000000000101011100000001000000010
00001000000010001000000110100011110010001010011100000011000001000000000000101000100101010010011100000
00000000000000000000010001000000001101000110000100110001000001001000000100001011101000001000100000000
01000001000011010000010100101100100101000000000000000000010000100000001000001010100011101000000010011
01100010100100000100100010000000010000001010100001001011011000000000011100101000100000000000010001001
00011001001000001000000010100100100000000001000000010010101001010001000010010100100100000100100000101
11010000000011110000001100000011101110000001001000001011100000000001100000100000101001000000000000010
10001101011000011000000110000000000000011110001100000100000000001101011010100010100101001000000010011
00000010100100100000101010011100000001001000101001000100000000000111000010001001100100100001100111010
01101011001000101001100001010000000001100001000000000000000000101001010101001100010001000110011100000
10000010100001010000001110100000100000001001001001010001111000000110010000000100001000001000111000000
10000110000000001100000111100000000101101110011000000011010001100000001011111000100010010001000000010
00111100000101100000001100010011011101100000100100000101110001110011000000000110101010000000101000110
10000000001010000101101101100010001010001010110110101000100100010110101011000101000000010101101000100
01000011111101101000100010010101100000000110101010100010110000000100001100000000100011101001000001110
01010101000000110011100000111110010110011000101100000001000101000000110110100001000000111000110100010
11100011000001110000001010001000101011001000001010010010000001100001101011010000000110011000000001000
00111111011110010001100010100010000100100100001101010001010011111000000001000000011010000000010000110
10010100011001010000100010000100010010001100010001100011001000010110100100000100001000000110100010011
00000000001100010100110100000000110000010000110000000000000001111000110101000010000000000001100110010
00010110100111100001000010010011000001110110000001010011111010100000001001000000111010010000100000100
00000001110101000000010001010110111000001000000110110000000010010001110000000100000100001000100101101
00011000000110100000000111001001010100100001000101000001110101001000000000000101001011100000000001010
10010100101100000101000000000001100000010010010001110011010001000000010000000001010100000010001001100
01000000000010100010011000010001001110001010100010010111010001011011000001100100010010100011000000000
11001000000100001100010100000000000010101110010100000000100010000001101001000010001010010000000010001
10100000000011000001011101001001100001001100100110000110110001000111000100000010000011000000000010000
11010001011000101011000010100101010000000000000110101010000000010010001000001001000010000000000000010
00110001101010010100001000111000000101100000100110010001000010101000010000010101110101000000000100100
00110010001000001111000001000011000110000010000000101110000001010000000000000001000110101110011100011
00100010010010010000000001000110001101001000000010000100100010101100000010000000010100010000100000100
01001100100011101011110001001101100000000001010110010011010010000100000100100001000010001001101000100
01010000000110000100000010001011010000010001100011010100000000000110001001000110101011000101100101010
01010010000000011001100001001001100000101000000001000101010100110001001000010010010110000000100000010
00100001000000100000010000000010000001100000000100001100011100001100000001001011110000000010100100111
01110010000110101000100011110010000001000000010000101100000000010000010010010000001010010001100110000
00000001000010000000111100001000010100001100011011000000000100010000000100000101001010100010001001100
00000001000110011100000101000010001001000000011110000100010000001010001000101001000001100001110110000
10100100010001000010100000011000100000000001100010011101011100111010000110000011001100001100100011101
01011100100100001010000111000000001101101000100001010001001010000101110000000100010000010000000000100
00010000110010010000111011001000110000010100001000001100001100000111001000101010000000010001100100010
10001011000011010010000100001000110001011100000110001011000101000100000010001100001000101000011101100
00000000001011001000000000110100000110000000001010001101000101010001000010100011100000010000000000000
00010000010100001110001010000010001000100101100000000100010110000001010000111001000000010110001000010
00101000010100100000000100101110001000100011000101000100000000010010100001010000010000001000001101000
10110000001001010100000011001000000001001000100010000001110010011000100001000100101001000000010001001
01011001010010000001100101000001001100100000111010100010100100000101100001100000010000001000100000001
00000011101000000000001000111100100000001000000001000110001100010001000000010110000000001000011101010
00011010001010000101000001000100000011100011100010001111000000000010000010000100100101000000010000110
00001100110010101000100001010010010101100101101101101001011000010010001000111000010000101000000000100
01000000101011110000100101000000000010101010110000011000010011000100010100000100011001000000000101010
00000100011010010001100100101000100000000000010100001010110000000100110100000100000101001000000000101
00101101001000000010010010000110101000000110100110011000000001110101010001000000010000110100100000100
11011010100011000011000100001000001011100010000101101010001001110000100000001001001110011000010000100
00001001000010000010110110000100001110000010100000100000100001011001000000110011110010000100000000100
01100100101110100011101010000000000010011000000000001000010011010100110001110000001001010000001000000
00000000000000011001000100100001000010000000010001110000000000000100100010001000011010100110010000011
11100110000100101010010100000000000001100010000000000000001101000000000011000001110100010000111000011
00000000011101010000000100000000000101111010000100000010010000000010000010110010000010100100000000000
00000010010010010010101000001010010011000000000111000001110101001000011001010001101010010001000101001
00000100000010000000010000000001000001000000001000010110111010010010100000001100000000001111000000000
10101010000000000100001100010010100001000000011010100010000000001000000100000101100000000000100000010
10010100100010101000010001101100000110001001001100001001001010101101000100100010000101000000100011010
01111000001110000000100010000000000010000100101000001011011001000000010100001100100000001000010111010
00000011010011100010000100000100010011000101100110011000001011000010000010010100100000010000010000000
10000000000000010101000000000010001000001000000010000111000000000010010000001000001100001111010000000
10101100110000011000000000010100000010010001001100010101000101000010110110010000000000000100110000010
10001011010010010000001001100010100110010000000000000000000010001001010000100001000000010101001000110
10000010001010101000000000011110100001000010000111000100101110100011001100100001101001001011001100101
01010101100000011000110010000001000100101000000110110010100000000000010011100000000010010011010100000
00101110100011100000110001000110111000000100000001100001011000000100000000010001000001000000001001001
10001000100010000110000100101001010000001100001101001100001001000000110011100010010000000000010101100
01000000001000000011000000110000101001010000001101001000000100000010101100010001000000000010001000110
00110011000001100100100100000011101100001001000100001010010010000100010000101000001011001000001000011
00000010000100100011010000101000000110010011010001010010000000100100001100001010001101000100110000000
