85 32
39 2
01010000000000100010001000000000010000101100001101110010100001010001010110010100100010100010011000010
10101111000100010001100010110001001000100100011000000100010001101001100100111000000000100000100000010
00011001100110000100000010101010100000011110010101011000000000010001001000000000010101001100000001000
10001000000000100000100000101000001000110001000010100000101011000011000000100100000001000010001000110
00010000000001100101110000001000100000000010010110001000010100110100000010011010000011100011000000001
01000101000010110010000000110100110110010110000000111010000110001000000000000001000100001001000100100
00000001000001000010000101000011000001011000100011010000010100010000101111100100000110010001000101010
01101010000000000110000100101101101110110001100100001000000001000011000110000000101011000000000101000
00000110000001010010000010001001010100101110100110000000100000010100010010001000000000011100101000110
01001001101100010001010001010001000100100100100010001001100000000100011101100000011000110000001000000
00001111010100111000000110000000001000001001001100001101101100101101101001010000000000000010100100100
01110000011000000100000100000111000100011001000100111011000000010011000001000100100010110011000100100
10000000010100000001110110000010000100010000001010110101000111000000010010000101101011000100010011101
01111011001010010011000010000000100001000010100100000100000100110000011101100001010100000101001100001
00010011010001010001001101111000010001100010010000001000101000000101000110000000000110001000010000110
00001000000000100100000010010001001000000000001101000011000000100011000010101010110100010000000011000
00000010000000100100011001001010000001010000000001001010000010000100010010010111000000110101000000100
11100001001101000100100000010000000010100000000000001001001000010001010010010000011000000000000001000
00000010100001001010000001101010001000110000000101000010001100010001011101010011001000000011011001000
00100000101001010110000011000000010000000001010000100000010101000010101000000100100010011000000100101
00100000000001000101000101100000000100010011010000010011101000110000101100000001001000100000000000010
00000000000000011000111010100000100100010001010001000100000000000100010011001101000010000011001000000
00100101000000011000010100000001100010101000000010000010001000000100010000011000010000111010001100100
00001001000001000000001100101000011101010010011110000001011010110000000010001010011100000010000000100
00001010100010010000000010000000010010101100010000011100111011110010001101100001101000110000110100000
00110100101000101000011011010100000100000010000010001010100000001000100000101000100010010100000100000
01001010000110100000000100110100001000000000001000100101000010100001011111100100010110001110000100011
00000100011001001101000101010000010000000100001000010101000000001101000100000000010000000001010000100
00000000011000111000000000010000010000000101000110101001000001000001100010000001100010100001101001101
10000100001100000000000000001001010000011101100010010000000010100001001101000100000000101110000000101
00101000011010100000010100001000010001100100110011011111101001000100101100111101100001000000100010010
10100110010000010010101000010111110010000100100100100000011001001000001100000100101010000110010000001
00010100000011000010000110110000000010000000000001010000110000010111100100000001011010000001000011100
00001000001010011100000000100110011001010101010000100010000010100000100110100110000001000000000000110
11101000000010100000000000100011010001000101100000100101011011001000100000010011001101010011000000001
00010000000000010000100000100100001010001111010000011001000010100010000001000100000101010010000000001
00111010001100110010000001001000110000001001111000000001100000001100000000000100001010001000000000100
01101000000110101000000000010011000101110010000000100001100000001000010101001001001100000001100001100
10100001101000100001000110000110110100001010101000000011010001000100101000001010010110010000000001010
01011101000011000010001000000000110001100001111000010000100000010000000010100000010010000000001010101
10000011101110010100100110011000000000100100000000111011000010000010000010010100001010000100100001001
00000000000000000000001001000100000001100101000100001101010001001100111100000000110101000000000010110
01000001100000010001110000100010101001100010010001001101000000110011010010101011000000011000001100110
01001000111010010100000111110010010010000011000000111000101110110000001000000010000000100100000000010
10001100100000000011011110000010110000100010000010000101001011000000010011000000010110010000110100010
00100110011000100000100010001100100110000100000110001000000001100010000100000100100011000000100101010
00001000100001011000000000100000001000100010000000000010100100100000000001100011001000000011011000100
10000011010110000000001010001001010010100010001110001110000100010100100000110010011001101000100001000
01110001110000000011000000000110010011010110000000000000001001101000000101010001010000000110010001110
00001010001110000100000010001000010100011011111010100000010010101011100000000000101000000000001100100
00001100001000010100000101001000110001010000000010001001001010011010000001001000010001100101001001110
10000100000110000010000001100001001001100010010011000000100000000011000001100100100001100001010000011
10000000101100001010101000000000101010101100001110000100001110000000000010001100000000000011000001000
00111100000000011010001000010100001011011001000000000000011000110100101000010010000110000010100100000
10100100010011001010000000100000001100010000100000000000000100100101110000010001000001010000010000000
10110000000111001110010000100000100001001100100011001100000001000101011010000000000101100000011110100
01010101011001000001101101101010000000101000000000010000010001011011010000000010000100010000000110000
11000010110000010000010000000000001000100110001100000010100001000000000000001011000000101101000001010
00000000010110110001001110110000100000010100010000000101000100010100100000100000010110100000010000010
10010101100111011100110000000010011010101001000001011100000001001010000001010000100010000000000000110
10000001010100000000000011000100000000000000110010100001010000000100000011000001000011011010000000010
10010000000000000010000000000000100100010000000001100111000000100010110001001010100110010101010010001
00010100011110000010001001001100101001001000001000000000100100000010100010011001001100010000000000010
00101000010000010010110101100010001000110010110010101001100001000010010001011000110100101111111000001
01000101001000110000101010100001010100010000010101101100010001000011001010000000100010000100000000111
00001100001001001000010000010000010110001100000010101000010100010110000010000000111100010101010000100
10101000000111111000001000000101001010100001001000101011111011010101100000000010100000010110111001100
10100011011000010010001110001000111001001000010010110000001100100010110001110111100010011100100110000
00101011001000010000011010000100000010010100001000101000001100011110100001000001110000000101110100100
10010001100110101011010010000000000001100010000001010000001000100000000010110110000100001101011000001
01000010001001010000111101010101000011000110100110001000010000010000010010000001000001001110100110011
10000010000000100001000100001000010010101010110000111010010101001000000000001001000000010001000101000
00100000001001000100000000110011110001010000100100000000100100100000110000010000000000000011001000100
01010000010100110100100100010000001000001000010010000010000000001001001001001100101000000001010000000
00100001110001000010010010100000010110100000000000100101010100000111011001011101100110000010011000010
00000001000110101111100000011000100001010000000100100100101101100100101011000101100100000101000001000
10010000010001100000000001000010011001000001000000001000001100000000101101000000100011001000000100101
01100000001110000001000110000000010111001110100000110100000100100000110100100011010010000110000000000
00010000100000010001101010100110101000100010010000110100111000010000001110011000101110001100000010010
01101010000010001000000001100000100100111001001100010000001011101010100000001010010001000100110101110
10001000000010000000101100000000000000000100001001000001100110010001101000001100110011000001100010101
00010010110000010001100001101000110000000000000000001100000001000110101001110100011010001100001000000
00010100110000110100001101011010110000100000001010000000001000000000101001000010001110101000000001100
11000000000000000101000001000001100010100100010101110000000010010101100000000100011000010001110000010
00010100111100100000111101010110000111000000110001110000010001010010101010000010000111100100101000001
10100000000000100010010100100000000000110011000000011001000001011100011100110100110111001001010011000
00010000110000010000000000001000000010001100101001011000010100000101110000110011011000100000000010100
10010011000000100110000001100000000001000000100000100010010110000000010000101001001100000000001010010
00000001010010011000000000110100010100000000001010001000101000110111000000101100000001000010000010000
01011000011110010100000011011100000010010001100001001000000101001000101001000000001000010000110100010
00000101000001001001000111000011000011001111001001000000111100101011000001100101110000011000000000000
00111001010000000010100100000001011000000000011010101101000010010000011001011011100001010100000001001
00000100000000100001100010111000010100001001110000110001110001000100011010010010011000011001111000000
00010000010101000000000001010010100100000100110101000010011000000010010000000010100010001000011011110
00000010101100000011010100001000011001000011010011100000010000111011010100111000101100101000000000000
00001000100000000101001000010010100001010000100010000100110001000000000000010000100000000000010000110
00111100000001011010000001110010110000000001110000000001100010100000110001000000010101001000101100000
01010100000001001000100110000100011110010011001100000101001001000000010101110100010001001000110001100
00010000110011000010101000101000000010000011000000100010100011100000001010001000000000000001100010011
00110000111100101000000000000000110010010000000000001000000000101010001001110100100000010100000010000
00101001000011000010000000010110000000100110010111000001010000000000000100000000010011011010011110100
