15 61
70 97
10000000100010000000100001001010010010000000000110100000001000000100000010000110100000110100000100100
00010100111011000000000001000010000100100110000011010011000011000000100100100001001000100010011100100
01000100001110001100000000100000000000001101101001000000000010011111010000000010010000001000001010111
10100010100101000000001000010111111000010000001001011000011000010000110100011100101100000000110000010
00001101000100011000001010101100000101100000010110101000000010000100010110000000100010101011000100001
00000100001000000000010000011011001000010000000010001010011010000010100000000000100000100101000010010
00000000000000010110000010010001010000101011100001000000100111000110000010101001001000010110100000100
01000010001101111001100000101000100100001010100100010000101000010100000001010110000000100010001000010
00000110000110000010001001010001001000000000110101010001011100001010100110000000100101000110101001011
11001001001000000000001000010110000011010000010010101100000001010010010000000001001101011101101100000
10000000000010010100010100010000001100100100110011100000000010010100101000010001000010100011101000000
01000100001001100110000000001000100101101000101000101010010000011000001100100110000000000100001010001
10100100001001000111100110100000100100101000000100000100101001001001001011011001001000001011010101000
01000111010110000000100000010101111000101001100010000000110000000000010110000100011000111000000101100
10001001100000000110000000100001000001101000000001111100010010010000011100111001010000011010011100000
10110000001011001101001110000000100000000000000100010001100000000100000001000100001001010000000110000
01000000001100000000000010001010001001001001000001101001000010000001010001110100101100101001000000001
00100001001100000000110100000000000010101010000001100000101010000000010100000001001001000011001100010
00000000001000000000110010001001000010000000001001100001110100100100100001010000010010001100010101011
00000101000100111000000001000011100000110010010010100000010011000000000001001011001001100001000100100
01101001011000000000001000001100010000001001100001010001000000001111000000000001000000000110010100010
01101000010100011000101001000101001100000000010010010011001000100110100010100000011010000010010010110
11001001000000100010001100001000110000100101100000011101000011110010100100000001100011001010000011000
00000000011010100110010000000001000001000100010100101001000000000100000010100000001011000000110110001
11001010100001011001000000001000010000001010001011110111011010101000100010110000001000000100010011010
01101010000010101011000001100001110001001100001000001000011000000000100111110000010011101100100000001
00100000010001001011000001011000100000000010001101100000000000100001000000010000010100010000010001000
10010100000000000010100000110000000000001000000010000111000011001000101100001100010011100000001000100
01010011000000100000010000010000000011001000010001000000000000110011100000111000001000000000011000110
00101000011001001001000000000000000110000001000011010001110000010010000000000010101000100101001100000
01000001001001101010001000111100010101000100000100100001000101010101000100000000111011011111100000000
00000000010100001110010100000110000000001000100100000000001001000010001110100000000000110000000011001
00001100100011001101100100101000100100000000000000000000000000011000100000000001001101000101000010000
01110000000110001010100000010010000001010101011100100100101100101010101000000000010000100010000100100
00000001000000110011110101000101110100010011100000001100111000000000000010000001110111000001000000100
00100000000100000001001001001001010100100000110100000001011000000001000000001000010000000100010100010
00100001000010100000001010000100100011000010001100000000000010010000001000101100001100101011010000001
00001000000000010001010000100000010010110000000111100001001110001010000000110010100000010010100100011
01001000000010000010000100001000100010000001000010100010010000000000100110110001000000010101100011000
00000000001010001000111010110000100001010011000000000001000101100000101000000000001100010000000000101
00000011000011101101000001010010000111010110000000000000100010000001000000000011100100000000011000110
00000000001000000111000000000100100000011000000101000010000000001010100010000000011000110001010001100
10000000010001111010001000000000000011100011001011000000010001000001001001010011000001000000010001100
01101000000010000000000100010000010100010100010010000000000000100001010101010000001010000010100000001
00011010000000010001001000000000010101000001110000000111000100010010101010001011100010000000000000000
10000000000111101011111010010000001000101000000000011010000101000000000000010011011100010010000011000
10010100010001000000001000101001000000010101001010011000100101101000010010001000010000000001000110001
01011101101010010110000001010100010100001110000000000000000000000011110000100100001100100010001110001
01100100000010100001010001010100000101001010100001101000000100000011010010001001000001001000100000100
00000000000000000101000101010000001000001011110100010100000100000000000000000000010000101000100101010
10100001001000010101100000000101010001110001000010001000100000100000010110011011100011000000010000001
00010100010000110000000000000100010100100000111100001000101110000000000100010010000100100100011010010
00000101010001000000101000001001101010011000010000001000011000000100100011010010111101000001000101000
11001000100000100101000011001001000001000011000010101011001110100011000001000010000001000100001010010
01000000101111001100001010100000010000100000101010000010110000100110000110111010001110011000000101000
00100000101100100000110011000000001111000101100010010010000000000000000101001101001000101001100000011
10101111000100010110010001111001011001111010000010010011001000001001010010001001000000000110000011101
01001000000000100000011011000110011000000100100010000001001001010100000110101010110000001010101100001
00010010000001100100000010001000010010010110000101100000101000001100100100000111101101000100110110000
00010001001101011100110101000000011001100000010100000000001001000001101001100100000001110000100010110
00001010001110011100000101000101001101010001000000010001000000101001100000000010001110010010111001000
00111110110001000100100000110110001100000000010000010000000100100001000000001000010100000010001001000
10000000000000000000100000000000001010000000010010110101001101100011001000001000100010011100011100111
00101000000000001010001000101000000010001011000000001100100001100010110000000000011100111111000000000
00001001100000010100100110100111100001000000001100001001000101011001010010100100000000100011100010100
00101100100000010000010000110011001010011100001000100000100100101100100000001010010001000010010111001
00100100001111011001100001101101100011100111001110100001100000001000000001000000100010001100110000000
00011010010010001001000000110000000000100100011000011000000001011101010010101000000000011001011001100
01010100010100000100000000110000100000000010100001001000110110010000010001101000000001100001001001000
10001001101000000000110110000100100100011000000100010000000001000111000110000010010000101100001001000
00000110100000100011010010011100110000100010010100010000011100100000000001100000000000000001010110011
10001010001000000100000000100100001010100001010100000010000101100000010000010001001100000000000100010
01101101001000000001110001101000010000010001100111010000100101001111010000000000100100100100010111110
00100000001011010010000001000001000001000100111100001110010111001000000000111000000000000111101010000
11101101100010000101000100100100100100001000000010010001100000001000011101001001000100010001100100000
00101010101100010100100100000000101000000001100100101000110100100001101100000010001101001010000001000
01001010100000000010000001000000110110001011010100100011011000110010000000010000010001000000011000110
01011100100000111000000000001010000000010000001100000001001110011100000100100100000100011010001100101
00100001000001000100100000010000110101101101111000111000001011011000010100100010000000000000000100100
01100100000001010000101000100101010000010010100011000000000000100100001001010000000111000001100100110
11000011010100000000110111000100001000010101001011000001000000010001100100100000001100000001010000111
00000100010110000111000100010111000010000010011001001010000110000010000010111110000001001000000101100
10010100000001000100110001101000100101101110110000001101000101011000001100000001010000000011010111011
01100010001010100001000000000000010010000010001001000010000000100110000111001000010001001001101011010
00000001011100010100000010000100100000100000000001000000001001000001100000000100101101001000110001100
00000001000000000010000001000101000001000110000000001000000000000000000011000000000001000000001000000
10000001000001100110111010000011010010001000111000010000001000000010001000010000000000000000000100010
00010000010010100100100001000101000011001000010010000000000000000110010000000100000001011010000110101
00110000000111110010010000010101001001010000001110000001100010011001000011010100100100001000010000000
00010000000000000011000100001100101000001100000110001000011010011010001000100000010110010010100010001
10000010000100000110000001000010110100100010000010001001000100100000000010011000011100110000000011010
00000110010001100000010101000000001001001101001110010001110100000110100000001001001001000001000111100
01000100001000000100101010100000110000101010000010000000000010100000000011111011000110010000010000010
00011001001011010110001011010010110110110111000001001010010001000000110000000001100000100010000100000
00000000001010100001011101000101010100001000100100100000000000000001001110010111010100000100100000000
01001000100100000001100100010010101101100000000100010000010100010000100100000000001011100000000000110
01000000000001100000001001001001111000010010000000011010010100010010100110000000001000000000111110000
00000100010010111011100110001000000000001111000010001100010110010100100000100000000001100100010000010
00000000001000001000110000000010100010011100000110000100010000000100100100100000000100000000010000000
00100000001100000000011100001110100000110000110010101000100010000001010010010100111000000010010010100
10100000100110100101001000100001000000100100100101000010011101000001010011001100100010010100101010000
