18 7
41 92
01101111010010100011101000000010001010000101101000101010000000000000100011110000100010010000010000001
00101000010000000000001010000000010101010100000100000110100001001000001000000100000100001001110011011
00001001001000110011000000010000110110110000100000010001000000100000000001000001000100000000001110100
00011000000001010010110000110111000001000101100100000100000011010001001100000000000001001001000101100
00001110000010110010100000000101011110100100010111010000100001101010001000011011000010000001010010000
01000001100100000110000000010000110101100100000000000111000111001010010000000010000000000010010001010
00000000000000000000111110101100100100101000000100001010100000000101000100010100010010001000001000110
10000110001000110011000010100011000101010000000100010101000000011100111001010000000000001001000011100
00000001001100101000001100000010000011100000010000001001010000000000000101101000000010010100000000000
00101001100100110000100110100011000000000011101001011010001100001100000001001010100001010110001001101
10110011001000110010001011101000100000000101000110110010110011000100100001100000001000011000000100001
01000000000101000110000000000110001000000000001000000101001110100101001010011000010110000101100110100
00001010000000010000011100011100110100111010000001000001001000100010000010001011010000000101100000010
00100101001111001100001000010001010010010010000000000001100100100100000001101001110100001110100000110
00110110000011001011000000101000110001000000010000100100100010000111001011010000100001000010000010000
00110000110000010100000100000011100001111010011010100110100100001001110000000001011000010010000000101
11001000000110110110011010000010000011001010100111001000100100000000000000011010011101110100101000000
01000000000000000101011000000001001000000011001000100101000111100001001001110000100101000001100000100
01100110011001101100100010101010100001100000011010000001101000100011100000111110010001000000010000100
10110100001000110100010010010000000000100001101000011000000000010000100111000000000111010101110100010
00111011101000000000110110011000010001011110001010000101001000100100100000100110000000110000000001101
01000000011001000100111100000000000101000100001000111010100010000011100110100100010001010010010001000
00010001000100000010001000010100000110101001101000001100100000000011010010001010000010100100010000010
01100010000100110101000010011011000010010101011111001011011010000110100001010101010001000001001000100
10000000010000000000000000110000000000000010010000010001010101000000000000100001000110100000000001010
11001010100100001100110001100100001010010110000001001100010000000100001000100111110010001010100100000
01100010000110000000100110100010001011010000110100011000110110110000100110001110100000000000010100000
00000101000000000101000010101000000110100001010000101101000000000000100001010010001010000011101000000
00001100101001000000010000000011000001000001100000000001000010100101000010100000000000000000001000011
00001011100000110010110000110000000000001000000000001100000000000000110010101110011100000001101000110
11010000000000000000000000000100000001010111000100100001100000011110101100010101111001101000100011000
11001001000010000000111001011010101010101000100010000010000110111001100110100000001010100000010000000
01000000010000000100001001000100110010101110110010000001000000000000000000000000000000110101000000101
00001101010010010100011010000001000000011000100000100000001010110100111001010000000100010111100110010
10001101001110000001100100010010100000000100010010000010010110010100000011001101011010000010100000100
00001100000000000000001001110010011001100010011000110010000010100000100110001001010110001000110100000
00000100000100100011001000000000101100100000001010010100011000001000000100000001000000101000000000001
00110000100110000110000001001111101000101100001000010000110010000000110001100100110000101000000010100
00100101001000100110001000100110000001000000111010000000000011011010010010000100010000000100010000100
00101000001100001001000000000101101000001101000110110011000111000101001001100010001110010011001000001
01010000000110000000010000001000100000000010001001010110001000011101001101010000101110100000000010100
01000001000100010000000111111100010010000011100000100001001000000010110000100101110000001100000000101
01000100000011000001000010100100101101100001000000000000000001010100001001000100000000000000001011010
00111000100000110010100101000010010000000000110010100000000010000000000110010010000000001010000010010
10101000001100100000000110000010000110000000000010011100110010001101000000001010000010001000100110000
10010101000000010001000001000010000001000101011000000001000000110100111000100001100110010010100001000
01001000000110000000000000110001110110001100000001000001000100000001001001100010001001000000000011011
00010010000000010010101000000011000001001101010011101100100001110000001000000000101010101110000001010
10010000110000100000000000100010000101000010001110010000011001000000110101010110000001000100000000111
01000100000010001000010010000000011000110101000001000000011000011010000000110000010010000000100001000
01000011011001110000000000101000000010000000000100100001000001000101110000000100010011110101010010011
10000000001000001100000100010000100001000000110000010001000001000001001011110011000001001000010000000
10000100011011001000101101011100110011100000001001001110010111000101000000000010000110111010010111001
00001000100000000100000001000001100010000000000100001000010100000100000101010000011010101000000001000
10000000010000010100000000100010001001001000001100000010010110001011010011011001000001000010001000001
00010000100011001101110010010110001011000010000100101100001000000010110010101100110100101100110000011
00000101010010101001000010010101011001101100100010100100101101011000010001000001010100110010101011100
10001011000001001000100000000100000100000100001001001010100100100000100010000010100011000100101001000
00000101010000010010001000010000001010010001011000000010101111010100100000000010111010110000000000110
11111010000100100101000000000010100110111000000010000110010001100000110011000010001000100011010100001
00101100010010000000100000100001010000000101001101101100010001000000101010111111001010010100100110000
11010001000000001000001000000000011001000001001100100101000110010010000110001100000000011000110010100
00001000011001010001101000001100000010000010000101100101010000000011000001010000110100001000000000100
00100010000010101000110000001000000000001101100010011000000001010011000100000101010011010000001010011
00110100100000010000011000001111101010001100010011101000100010110000011100100000000000001110100010000
01100000100011111000011000100010011011000010110010000001011010011001001001001001001001010010000010000
00100100110100001100001001001000001010000101001001110100110010011010100000001000011101000011101000000
00000110100101101000010100000010001000000001100110000011001000010011000100010011010001000101010000000
00010000001000000010000000111010110000100010000001000000001000001000000110000000010000000001000010100
10100110000001000100011000010110101010001110010111010010000000000011100000000000000101000000100101000
00100100010110101000101110100100000000000110010001000011010001010100001010100000000000011000001011011
01000010000001011000010000000110001000010100000110010001101111000000111010001001001000000101110001000
00010011000101111001101011001000000000011100110011000100100100000001110000001101100100011010010000000
00001101000100000001110001100000001010000010001100111001000010111001000000001000000100000010101101000
10000001100000010000000000001000000010000101100110001000000000110000111010100100000000001101000000000
00000011000000000100100001101100000100100101010000010100110000010001000000100000001010000001100000101
01001000000100000100101000001101011010000001001010110000000010101100110100010001110010000001000100011
00000100000001000000100010000000101011000010001000000110000100010100101010000000101101101110100110110
00100111000100000000111000010000100000100001010001001101100010100010011010000001000010000100011100010
00100000001010000010100000000101000001000101100000000001000000000101001000000000001000111001001010000
01011000001000000001010001001001000000000001100110011100110100010001100110011100101011010100001011010
10101000100101000000001100101110000110010000001100101100100001000100001000000100000000001000000001111
01000100010000001010101100100001000100000010011100100000000010000111000000101110000001001110100001000
10001100000010000000100010100010100110010010000010000000000100001000010000101001010000011100000000000
00110100000001000101000001000001000000010000000001101000011010000000010000001100010110000000000010010
00010000000000000000000010111010000001101000010000000000010100010100001010110000100110101000000001000
01111101110000010000100001000000000011100001000001000000000110110000000100011010001110010101000100001
11000100001000100000010010010111000000001100000110001000010000110000001010001000000010010010010001001
01001001100000010011100001010000010100000001000110000010011100000000010001000101101000000000000010000
01000100000010110001010100100000110000110001000001000111011001000110001110000010001110101110001001000
00000000001100100001101000000011000100101100001110110000100000000010100100000100010001111010000001010
10010110011000001110000101000000000001000000001000010001010100010110000001010110010011010010100010101
00000001000000010100010000101011001000001001010001110100000101000010000001011001001000010011010100010
00000110110000001000100000000011001001001000101100001000001100000000011000010001000000010000010001100
00000010011001010001000011011010000001000011110100111000000010001001111000000000010101000001010110001
10011001000010101010010010011100001000001010010010100010000011001100000000100001100001000010010101001
10000000100000011010110011000000101000000000000000110010101010010000101110000110000001001110100001011
01000100010011011011001000100000000000111000000011000000001100001110000010001001011100000100001110000
00100000000010000001010000100000000010001100100100011000010110000100101101000011010010000010000011000
01010000100110000001100110000000000000010011000000010110000100011010000100111100101001000000000101100
00000001100110000000001101000101001100000000100010100100101001000100100010000100010011010010000000010
