60 46
63 67
00000100000101000000000010000100000101100000000010010011010100010000001010101000010001000010011001010
00011000000000000000000000000000000000001000000101010000000000000001101101001000001010110001100010010
00100000000000000100100000010000010000000000101100010100000010001000100001100001000001001000000000000
10000110001010110100010010000000010000110100011000001100100000010000011011000010001011000101100010000
11001100110100000111100000101000000000000000000000010010101010001010110000110110100100000110100101000
01110100110001010110001010000010000000001000011010000010000001000111010000100001101110100001100111001
00000110000110100000000000001010000010001011101000010001100000001000010000101010000010000110000000001
00000001010100000000111101000101000011000100000000001100000000000000001000001000110111101001001100000
00000000100000000101011001000000000000111110001010010000001010000100010000010000001000010101010001100
00001000101000101000010000011100000000110000100000010001000001010100000010001000011010011000000001000
00101100010001011001010111101010010100010000001010000000100101000001010010100000101000010010000010000
00011100001100100010011101001000010101000000100000000101100101110110001011000011011000101000100001101
00000101100010101100000001010010011110011000001000000100111001010101001110000000000100000000000100010
10000000101001101010111000000001000000000011010100000000101001000001000000001011001100010010110010100
01111000111000001000010101100110101100010101000001010000010100000000010000100100000000000011001000000
00001000010000100000000011000110000111010010000010100010100010011000000100101000000000001011110000000
10001001010111000000000000000000010011100101100010100010010000100010101000010000000011000000111010010
00010000010011001110001000000011000000101110000000010000010001010110000000000110100000000101000110100
01010000000010000000001001001001000000110010101000011100001110100010000000000111010011101101001100000
10101100010110011100001000000000000000000101011001001001001000111001000001000000001000011100001001010
00000001000000100001001010000110000000011010000000100100000100100100000100101000000000000100110001000
00100010000000010100010100100001110001000000000010011101011000110100001001010101110000000101001101000
01011101001110010100100001000010100110000010010000000001100100000100000010011110010000001011010110001
00000110000000110110100100011100000001010000001010100000000000001000100101000011001000100100000000101
00000010101100000010000010001000101000101010110010101000000000000000101111010100000110000011000110010
00001000010011000011100011100000011101110101000010000100010100111001010000100100001001000000010000000
00111000001111000001100010101010000001001001000001101101001001100100000000010000000100110010001000000
01101000100001100100000101100000000101100010000011100101011110000000100010010100000000000000001100010
00000100001000100101000010001000100000000001001000001100100011001010001100100001001110100010011000000
01000000000001000100000110100001110000000001001000001000100001000000101101011000000001100101010111100
00000010000101000101001110001000001101101001010000101010001111100100110010000000011000010110011001000
00000000101001001000001001001000000100111110000001001100101000100000000000101000101111000110010010000
10011110011001111010100011001001000010000010100001100000100000101011000010010010000000000010010010001
01000000000110010000010010000010100001001100101101001110101010101111000100100001001000101000000000000
10100001000010101000010000100011001100110001100000101011000100010000001101100000100000010101010001101
00000000110000101000101101110100011000010000000111100101110100000101000110110001000100010100011011010
00001110100000100101000100000111101100100000000010011100000000100101011010000001000111011100101000101
10100010000000011010100011000100001000000000010000000100010000000100011010000000100010000011011000000
00100011000000000000100001000100101110000110100111000001001101000001001000010000000010111000000000000
00001111010000000100010100000101001100011000001101000010001010111100001010110000001000001000110100000
11001100001000001101000110010001000011101000000100000011000001100000001000000010000001000010000001000
00000000100100010000011000100011001000101100100110001011100001101011001000011011100000000000010101000
10010001000000000100001000010010000000011100000000001000011010000000000000000101000000000100110010000
00000011000000000101001000000101101000100110010001001010100110111001001000110010101100100011100100100
00010000000100000001100100010000101010001001001000100011010011101000000100101000100000100000100000001
00010011110011100000110010010000000100001010000000011100110100010110000001000001101001000000000010000
00000111000001000000000000111101000000000000010100010011011001110000010001101000001111000000010000000
00000100000101000011100101000100011000010010010001000000000001010000101000000001001011001000001011011
00100000000010000110011101000000001100100100000000001011000100001100110110111010001001010100011010010
00001101000000000001010000000100000001100100100100001001101101010111000010101110000010010000000001101
11000100001010110100000100010000000100001000010100011000000011000000101110001000100000010000010010000
00100001010010011000010001111011010000110010001010000000111001100010110000011010000000100110011110000
01011110001100011101100000000000100000000001011110011000100000000010100100100101001000010000001000010
00101011100010100000000001000101001000011000000001001010000001100000000000000010001111001000100000010
00000010100010001000000100100000010110000001100001101001010000000000001011000000010010000000000100001
10010000111001001001010011001100110101001000110100001101010100001000001000000011001001010010000000010
01110010101001001001000000000100000000110000101010010000110110000000000000010000000000100000110000010
11001101100110110100000010010000011000111000001010001011100011000110000010010010000000000000000001001
01001100000011000000010000110000000101000011000010101011001111010100110101101110001101000111011000000
00001100001000001000110001110101000000011000000010000000000000110100000000101010000001000101101011001
11100001110000101000001110001101100101010010100100010100000000000011000011010010010100001000001010000
00011100001000010001000000000000001111000000000110011000000010000000000011000000001100110110000001000
00000010100101010000010001010010100000111100010000001011111000010000100100000000000010000101001111000
00000000101100001010100101100000000010000011100110000010110100000100011000110010001110001010000000010
00100100101000100110101000011000001010100010000100000100010010000001000010011100001001010100011011000
00000000100000101000011001100000000000011000100000000010011101111010010010001011000000100001010000001
10010000001100101000001110001110010010100000000001001100001011001011000000100101010000010001000011010
01000100100000010101100010000010001100100101101000000001110110000001100000000000000100100101011100001
00010001011000110100100011100100010000000101001100000100001000100000000010000011010100100000001000000
11000100100010110010000000110000100011010000010000100101010000110111001100001100001010100011100100000
10010101000000000100101000110001000001010000110000000000100101000110001001101100001001100000001000000
10000011010101011101101010100100001100111000001001110001101100000000000000001010100000100010000011100
00000100010000000110000011100000000010000110001011000001100010001100010000110111000000110000000010100
00000000110011010000000000110110000000010011101000000011001011000000011001000001000011101010010000000
00011000011000010100010010011001100101100000100000000000010000100000110000100100000000011000000000011
00101101011011011001000100010010001100010000000000000000010010001000100001101100010010000100100001000
00100000100000001000000110000000001001000010000101000000110010000000111100011000101000010001010000110
00100101000010010100111000100000100100010011101000100000001101000100000110000000000010000000101000000
10101110100101101011000000001010100000001100110000101000001000001100000101000010000000001100000010010
01000001001100001100000100001010001001011000000000001001100010001000000001100100100010000001100010010
01000000001100010010001011000110101100000100000001100001001010000100000001001010001000000100011000010
00101010010110101100110100100000000100000110100100100000011111000000000100101001100100101001001001010
10010000101001011010101010000000000000011100001000001010000100001001000100000011000001111100101011101
01010010110000000001010101000101001000101010010000000000001000000000001011100010000100000001100000100
00100100010101111110001001100000000110000000000001110110001000100100100100000010001010000101010100000
10000011001000010100000100000000000000000000000100000001000100100010000110101010010110010010110001110
10001110101111000000000000100000100101001001000100000011000000000110100000111011000000111000101010000
00000110011000001100101110000011000100000000010001011100000011010100100001000100011100101110010000000
00000010101100000001001100100100100011001101001110100110000100001010000000101001010000110001001010110
11010000001000010010000000001110100000000010000100100101001001000000000100010001100010100001000111011
00101000000000011010000001100000000000101110001100011100010101010100110000000001101000100000010000000
01110100000000010011001000000001001110011001010100001000000000001100010000001100000001100110000000001
10000000101101100000000001110000010000100010001100100000100010001001000000001100000000000000000100010
10110000000010100010001000110011010110001001000010000100000110001000011010000010101000010001000000100
01010000100010000010000100000001001001000100100010000010000100100000101010001010101010000100011000000
00000001100101000001010000010100010000010000000000101010001001000000010000000000000100110101100010100
01010110000010111000010100000000011100000000111011101000000000010000000001011001011010111000001011000
11000101010000001101000001100000000000000000001010000001100001000100010010000000001011000010010110110
01000100100100000111100100001000000001101000100001000001011010110001000010100010001100101101010001011
00110000000000100000100000100010110001010000100010010000110100011100000001010010100010011010010000001
00001010001000100011100100010011000000101000001000000001100000100011001010000000100001011001001000001
