84 11
66 24
00000100000101100010100000010100000011100000000001010010011100010100100010101001011010101010010101010
01000000100001100001010100001000000110000110000000000010100010000100001100000100100101011010101010100
10010001010100100010101001011010110001001001001110111000000010001110000100100000100000000010000001000
00100000011000100000100000011000001100100000010010000101100010000001110111100111010010001110000001000
01000100000000101000100000010000000000000101010011101000011000000010000000111000010000000101000110000
00000001000100001010010001010101101010001010000100011010010011000001010010000000000010110100001000000
01000110000111000000001000100000000110000100011101010110000100001111000010010110100000100000100001001
00000100010001000110011111001101001000100000001111001001010010000001110110000010000110100100000000110
00000000010010010000010010101000000000000000100000100100100100000100101010100001110000110000011100011
10011001000000100111110010110000001001100011001111001001010000001110000101110100101001001000100100001
01000110100000100000000101100101100000001011000000010101111001011011111011000011000100110100000001000
11110101001100110001001100001001100100000010010011000110001010100010000010100111000101101010000010100
00100110011001001010011010010001010000010000000011110100100000110100100100110000010111010011000100010
01000110000001010000100100010000010100010000010000000010100010010101010010010110100010001000011000010
00000000000000000000010010000000001100001110100100000010000001100001110111000000010001000001000000100
00100010100110000000000000110111000010000101100000000010110010100000000000100000001000000100101011000
01000000000000000011010101001000000000000111101100000111100100101111000000010010000000011010011000110
10000100000000000000011001010010000110010010101000100000001010001011010011010101010000000100110100001
00000000000001010000001010110000000001010001000000011100100011110010000010000010010000011000001001000
11110000000110010000000000101000101011000011000000110000111001000000100111000001100101000000001010000
10100000000000100001110000000000010001100000010000110100010000011010110100100010001100100000100010110
01010001100010000001001000000010001110000100100110000001001001000001000000011001000000110011011010011
10001000001001001100101000110011100100000000001000001100110000000000000001001011001011000001100010110
00000101000010000111100000100100000000100010010100100001001100101000010011000110110010000011011010100
10001000001010100110011000111000010100011001101010001100100010011101000010000001100000010010000110001
00000010010001010011010000110100001001011000001010010010000000110101001000000001010000110010000100011
10010001010100101000000000001101100000010011001111000010000011101100010110000000110010010000111010000
00100101100000110000001000000000111011110000010101100001010000000011110110000101000011000000100001010
01100010000100100000000010011111100100010001001001000000010011000100001001101101000010111010000000110
10011010001010100000000001000000001000011001000010000110000000001101011010000001001101010100000000000
00001100010101000001000010110000110000011011001000001011001011011000000011010000000001010000000011000
01010000011110001000001000001011100000001000101000010100010101000010000101000000000110000101000000000
01101000100001010000101001100001110000100001010000010000011010000100110000000000000011000000000001010
00000110111100000000001000010100001101001000110000100011000010010010001001011000100101001001000010001
00010011010000100000110100100000100001000000010010000000111001000000110000100010000001010000000000100
00101000111000101110101111000000111001000110101000000000110000010101010001000010100010010001010101011
10001010000101001000010010110000000100000100000000001001000100100000001000010001000001001010010000110
01100010111010010101000000110001100010001000011001101010110000011010011000110001001010100000000001100
11011100011010011000001100010000101100001000101101010010000001000011001000101101110001001010000000010
11100100110011000000001111000001011000100001011000001000110010100100000011010101000010000000011110000
00100110000000101010010000000011001000011001110001111010000100001100000111001000100000001100110011000
00010110100100100010010000100101100111000000011000100010100100000001000101010000000001010000001000010
10100000000000011000000100011000010100010110000001001110001100001100000000000110010001010100010010101
00000100010010000100001100000110000000000111010001000010110010001010010100000000010000001000001100111
01101000101011011001011100000001000010000000101001010110000010010100000000100011000000000100001010100
00000001000010101010100010011110100100010010010000000011000010001000100010011000100100000010001100001
00110101011100010000110010010101011001100001101110000000010001000000100100010000010000000010001001000
01010101000100110101011110101011010010000010010101000100000000000000110100100110001000000101101001010
00001001101001110100100010000000000000010010000101010000001000110110000000000100100001011000000010001
10001000011100000010000101001101011000110010100100101000000001001011010110111000110110010000110001001
01000001100000000000011100000010100111110100000011100001110100000010000000111110001010101000010101010
10100111010000000100010001000000000000010110010101000010100010010010000000000100101001000010100010101
01100001100000100100000001100000100001100011101001101100010110010000000101000010000100110100000000000
00010000100001000000001011010000010100111100000010100100100000101000100101000001010110011100110001111
00010011000010000100101010000000001100000000100100101101001000100001001010001010001000011001000110001
01001001010000000010101111011100101001000001000100110101000001000100101111100000110111100100011000010
10000010000000001010000100001100100010010100100001001110100010100000001000100101001010101001010000011
01000101000000010010100010101010010001000001001000001001000100000001011000001011100010110001000111110
01000000001101000011000001110000101000011000000000000000000110000000101000100000101000010010001101001
01000100001000100100000000000000001010010000000001100001000100010001000000000000100100001010101010001
00000000001011010010000010000111000000000110100010001000010000000010000001110000000100010100010000100
11000001011001001100010000110000100001110100000010001100011100010010100000011001001001000010001000000
11000001000010110000101000101110000100000010000010000100110101000010000010100010111001100001000000100
00100000110000001011001100001011001100001000000011000100000000000110100010010011110011000100000010000
00010000101010000001110001000011000001011101000100100101010100000000110101100000011000100001000011001
00010111100000100000011000110010000010000101110100100000011000000000101100000100000100001000000110010
00000000100000100100100001001000010000010011000100000000000010000000001001100001010010000000100010011
11010000010110100000001110110110010010000100100001000001001000000110100000000001000011000000100011001
10000000101000001000001100110100111000001000110001010100000001000110000001000110000000000000001011000
00100000000010001110010100111100000010010000000000110000000100000100000000000001000010010010100110000
10000000010101000010010000000000000011100010010010000000000101111000100000000000110001100000001010001
00011000000010010000100010001101100100001011010110010000000101000001100110101000000100010110001001110
00000111000010000000101000100110010100000001010000000001110000010001011110000100001000010111000101101
01111000010100011000000011000010111011010100100001000110000010000010101000001000000001100001011001010
11001011001101000000100100100011001000001111011100000101100100001011011000010100001100101111110001000
01001000000010000000100010000101110101000000000100000010000010000100000010110000000000000010101001100
10000010100000010010011000010101010010101001010000001011001000000001000000001000110010001010000001000
10100001101010001001000010001010000000010010011000010010100010000000110001100000011000010100011100011
00100100000001100001000000000100100000110000000000000100001111110000101010001100001001000000011010000
00011010100001000000010000000000001000000001111100100100110000101000000000000000110100110101100010010
00000101000000000010100011000000001001101010000001000101010000001010000110000000100000001000001000000
00000011010000101101010101100100001110000010000110001001101000010100100010000000100000000101101000111
00001001100100101000101010000001010100011010100100111000000000001100000101010000010110000101001101010
00010001010100000100000001000000001000001000000010000101100001000001001101110110011100100100010000000
00000101100001001001000010111110010001000101000010000000010100000000000000000001100010000000000100001
00000010000010011000010110011000110010001110001000001000010010100100000011000000110010010001100000010
00100100110101101111101000011100000001011010000000001001000001001001000101001010011001000010001001100
01010010010011000110100000010110001000000010000010011000010100101010110110000100000001000000100010000
00100010000010000000101100011011100000001001000011010000011010101011000001000000100000111011000011010
00010000000100101100000000000010010111001010001000010000100010100001011001010001111001000100100000010
01101010100001100100001110010000010100001000000011001000000001000010010001000101010000000000011000011
10000011000001000010010000010000101010000011000010001000101000100100000001010000101000110100010001000
01000000000000000100110100001011011010110001111000111000101100000100000100010010000000000001010110000
01000100100010011101001000000000000000000001000100010000100001010100001011000000000100101001010000011
10000100001110101001000100000000000000000000001100010110010000101011001000100100100011010001100000100
01000001100000110010010100000110100010000010011010001000010100010001000010000100001110100000000010000
10010111000000000100110100000000001000000110000101010010010101101110000101010001000101000100001111010
10001000000110011010000000100011100100110010010010000000000100001100010000111100010000000000001100001
10000100110100001100011001010000000001000010010000111111010000000000000110000010100000011010111001000
01100110001000000001000010010011110010000010011000000100001000101011001010001111000100100001101100001
00000000001101111000000101000010010100000000000101101000100100100000111010000000001100000000010001001
