31 80
37 56
10001001000010110000001010000000000000010000100000101001010001101000011110001100001000000000010000000
00000011010101000010010101100010001001000100000100110000001001010011110010010000000000010000110000010
00100000100011101010010100100000001010010000011000001101110011001000110001000000000010011000110011000
11101111000000001111001010011000110001000101101001011000100110100010000101010110101010000010000001000
10000001001000001000010001100100100000001000010111001100100101010000100100111000000010000100000100010
00000000000100111100100100001000011010000001101001000110001100101000101000000000100000100010010000000
00010011100100100001000010110100000000100001111111000011010010101000000010010001001101100000000011111
00110000000001100000101110101000010001010101000100110000100000010000000110011001010001100000010001001
11010010101101100000100100011000100100100100000100000010001000100000000001000001100100000000101000000
01001000000001100101111001000000000010100000110001001000000101000000110000000011000000110101001100011
10000001100000010000001000011000100000000100001010101010000000000100100100000001100001010101000000010
00100001000100000010001011101110001100010100000010000000101001111000000000001100110001100101000000101
00100000110010000100001100000001000100000010001110000011010010011000110000010011101000011100000010010
01000001010100000000000001000001001101000011110010000100000110100110000010001100000100001000011010000
00011001100010001000001000110100010000000010100000010010100000100000010110011000001000101000101001000
10101100000000110000000010000010000000010100001001000000010110100011000010000000000010100000111011000
11100000100000000000100011011000001100000110100100000000000001000000100101100010000001000110001000101
00001101100011010101010000111100000000111000010001111000100010100010010001000101100001000010111110101
00011010000000001110100000000001010010101000010101100010101000011010000001101100001111000001000000010
11000100000010001000010011000100000100000100101000010001110001100001000010000111001000000001011000000
00100010000100011000000000100101001010001011000000010000000010100000100100000000111001100000000010110
00010101000000011010111000010000010000010001000000011110100000000101100101111011001000010000000100010
01000010101000010000100100000000000111000001000001000001100100000001000000101100000010000001000100001
01100101010000110010010100001111001100101101000000000010011100000101010110100100110000001111000000000
01010000000000010100101010101010011001110001001100001010100000000011000001010010101011000001010010000
10000100001010001001000001001110100100010000001000000010100000000100100000000001000000101001000000001
01100100100010110010110100000100110010100000100000000000100101001000000010000001011001010000010100110
00010000100001110000000001110100000100000010000001000010010010011001000000000000000010000010000000101
01011110000101011101100101010000001000001100000010000000011110001000001000101000000100101000110110100
10010100000001001100000001010100100000000100100000000010000010001000010100011000111001001000000010010
00001000011000000000101010000000100001101000011111000000010010000010000001000000011101110100100110001
10000011100110100101000000011001000000010100010010001000000000111100010100100010000011100000000000000
00110001000000101100000100011000111000100001101001100000000100100000011101101000001000000100001010100
00100100001100001000000000001110101100000000010010011000110100000111100001000000000011000001010000011
00011000100100000001100100000010010000010000011000100001000000011000000010101100001001100000001010010
00000100010010100000100000010000010010000000000100000011001001011000100001000010000001000000100101010
01000001101101100110100000100000001001101000000001000010011011001000000000001010100101010100001100010
00001001110001101011100000000100000000001000000000011100010010000011000000100010000011000101001000100
10000011000000000001101000101001010000000000010010001000000000010000110000000010000011000100100000100
10101001000001001101101101001100000001001001100000101000111101100110001001010011011010000000110110000
00000001110101001011010001000000100010011000100100101001001000101000000100000000001000000010001000011
01001000000011100100010100000101010000001000010000001010101000000001000101011010110100000000000100001
10000001100100110101000100001010000000101111000011101100110000001010010010101001010110000000000010011
00011001000000000000001111010100000001011011000001001101011100000000110010000010001100000000001010100
00100001000011000010100010000100101010100011011000010000011000001110111110100000100010001001000100100
00011110010011000100110110010001000100110001110100001111000010000110000001011110100000000010001000000
10110000100100010101101000000001110100100000110000110011100001010100000101101100100000000000000000010
10110010110001001000100101000100000111000000010000000000010000100000001110001011001000000010100100000
01000011010011010000000001101101110001000011100001000000101000101010011000100010000000110101100000110
10000011110010011001000100100010000000010100100010011000010001010000100001110101011010000101100001000
01100000100000010100000110010000100011100000010000001001001100000001001100000000000000010000000101000
00010000000100000001001100000101100000000000100010000000010110000110000000101101001010000001001100110
10000000001000011010010010100001000010110001000100010010001000000000000101101100000001000000010000000
00000110000001010100101101010100000001011101000000000100001011010011011011011000100000010001100000100
00001001001010010100001010000000001010000000110111000101100000010100010100101110000000000000001010100
01100010100100000011011000010000000000001001000000101000000010100100100100000010000000000000000110100
00000001001100100000001001110101000011000001010101111001101000110001100000000000011001100001000010000
00101010000100000000011000011001000001000010100010010010001001100100001010000101000000010000101010111
00010100011000011100011000000011110000000011000110100000010110011001010100000001100000101000000000100
01000110000010101011100100000000000000001000100000001010100010000100011000101010000010100001000011000
00100000100000000000100000000000101001011000011100001010010110010101000010111000111000101000000110010
00001000110001100100100000000011101000001000011000001101000010010110100000000011011000011000000100010
10100001110001010000100001001001000001100000000000001100000100000000010010010010100000000000110001000
11010110001101001100100010011001001011000000010000101101100000000010101000011100011010101000000001100
00000000010000001000000100001001101010100000000000010010010000001101101110000010000000100010010000000
01000000010111000010110100010100110011010000110011000110110001110010000110000000100100000010101000100
00001001100000100100000010001000000101000101011100010011011010101001000001010101000100000100100000001
01000110010000011101000010000010000000001000100000100010001001010000111000000000100000010000111010001
00010110011010000111000001000001010000010000100101101100000000000110000100100000100000010011110100110
00010010100010010010100100010010100011000011011000000110000010010000001000000010001000100000010100011
10000010100000100100100010101100100000000100000000000000010110001010000001010011000110100000000000011
00101000110111010100100010001001111100100011101000010100001000000000000100100000111000011101001011000
00011010000100010011001100001000011010010010000000000100000011000000000110100100000100101000001110000
10101000000101000101001010000000100000000001001101010000000000001100000010011000010000100000111010010
10010010010101101010010000000010000100100001000110000101001000101001010101101001000001000110000011010
10100100100010000010100000011100101001001000100000100010101010001010001010000110000100010010000000101
10001110000110101110000000010010001100011000000000100000100100101000100011100011000010001011000100000
00000000010110000100100001111000000010000011100000011000100001100000100000000000000000000101000100010
01100000110010001100001101100101010000000001001000010000000000000000001000000000100000000101100010010
10010000000001000101001000000000010010000010100000000100000110101000001000010000000001000010000000001
11000011010000000001000001110100111010000101011010000000001000100110110001000000001010010101100111110
00000000000100000101000000000000001101010000100000001010100000000000110101000110000100000100110010010
10001110110101000100010000001001000110000100001000000010000000000001011010010000001100011001000001001
00000101000001001000010010000010000010001100000100010000100110000000101100110001000100000100000100001
10000010111100111011010000010001000000110101011000001011000010000000001010001010001000000000000000011
01011010000010000011011010000000010000100000010100000000000000000001001000110001011000010001010110010
00000000100001000000000010010110000001000010000011110011010000000100000000001010100011100001000000000
01000011100100001010001101100111000100010100000001000001100100100000010000100001010000110001000000010
10000000000110011000010100110000010110000000010001111011011000000101010010101000110000010011010000100
00100010010100001101011111000001000001000111100100100000000010001010100010100101000000011111010010010
10110010111000000000100010010011000010100000101101100110000110110000001101000010100101000101110000010
00010110000000000000000111000001000001010000000101010000000001000000101001001001001000010010000101110
00011000101011010100100000010000001010010000010110100000010001001100010100000001010010111011011000100
00000000100100000111000000011010010110101000000000000100000000010001010001000001010000000000000010000
01010000000000000011010011010010010110010011100000000100001100000100001000100000000100111101000010010
01000000010010101010000100011110000011000110000000000000010010001011110000101000010000000000010000000
00000000000000000010000000010110000001001010000000010111101000000000000000110010000100100001000011000
10010000100000010100000101010110110001001010000001100101100000010010110001101111110100001011000010110
01010010000001000000000100000000001100110100000000110101000000011010001100010000010110000000000001010
01001100001000010110010110011010010000000000010000010010000000000000000001010000000011000100100001000
11000000000000110001011000011011100101101101010100100000001001001110100100100010001110001001010100000
