35 83
9 85
00010100100000100101001011000010000010110100010010100101101100000001001000110010000111010011000010000
00100000000000111010111001010001000101010010000000000001001000100010000000101010000000111100001000001
10000010010100100000000011100000010110010000110000010000000000000101010100010011001000000011010000000
01000010001010001000000000001000000010000000001010011111000001011000101001000100010100000000010110000
00001000100101101110011000110000001110010000001010001000011000000100010000110000001010000010000000010
00111000000110010000010000011011000000000000000110000010000010010010010000001000100001000010000100000
01000000010000000100011010100100100000000000000000000010111000000110000011000000000000010000100000010
00010001001101000000000110100001000110001100010000000000000001001000000000100110011110000000100010000
10010000000000000011100100001100011001001001001101010100010000001100010111100110000111000000011000000
00001000000001001110100000000100011001000000101101010100000000011010100101001000110000001100001000010
00000110001110000001001100011010100010000001010010110000000000000100001000101010011000001101011010000
00001001000010100001000000000101100110000010001000000001010000000100100111010010110101010001000101010
01110011101000010010010100001101000000101010101101100000100010101000100110000011100010110000100000001
01001000000000000010110100010001000111110010010010110000110001100000001000000101000001000100001000010
00000001000101010100010001101001001001000000101000010100101001100000010110011100000000010000010000000
01111001000000000000001001100010000110010110000100000011001000010001101011000000100010001100100000001
10000000000000000000010101000001001101110100010000000000101000000100100000011010000000000010010000010
00000010001000100110010000000001010010001011101001101110011100100010000011000010011010000101001000000
01000001000000010001000010100100011001111001000001000010000010000001000110000000000001100010110000101
10000110100001101110000000000010011101010100001000100000001010000000010101100000110100000100000011001
11011010100110100110001010000100010001001101100100010000001000001000001101000100000100101000000010000
00000101000000100001001110000010010000010101010000001100000001100101000000000000111010010011110100001
00001100110001000001111101000110110011000010000010001010110000000001000100000000000000000000001101010
00110000000000000001000010111010110000001000110010000100000000110000000000000100000000000000110101010
10000011100011000010000101000001001010001010111001100010011001100000001101010000001000100000010010001
01000000000001011000000000111000010110101000000000101000101101001000001100100010000011000000000000000
10110100000000011011001100010000000101010100010011011010001100111000111010000100000001110000000000100
11000000000010011001001100000010100000000000001001010000100000011001100001001110001001100100000100010
00000000100010000000100000010010100001000000000101100000010000001101101100000000000000011010001000100
10011010010001001000010010001110100000101000100110010000010000000011010000000100010110101100001000101
00000010000010110001010000000110100101100000111000000101101101000000000000000011010000000011100001001
00001010011000000011010110000001010100100110001010100100001001100000001011000000000101000010101100000
00100001000101010000110010000000000000010000011000100000101000001001001011100001101001100001010110000
10101010001010010000000101000110010101000001000100000001100010010000000010000011000000010101000010000
00001001110100001010110000000000100001000101101000101000000100101000000000010011010111001010001000010
01001000000011000100000000000001000010100000100010100000000100000001101100000110110010000001010010000
10000100000011000000101000110000000010101100000100110000010100001110000100101001000000010100000010100
11000000010001011010000101000001100010000001110011110000000110001101000100000001010000100000110100100
00001110000110001000011100101000101100010001000000000100010111000000100000000110001001101110000001100
11001000010000010001000100001000000000010101001000000000100100100111000000011000111011000000001101000
01101000000010110010100010100000100000101000001010100000000010001011000000100000000000111110110010001
10000111000000000001101000010001000010010001000000010000011000000100001011010001001010001000001011101
00000000001000000110101000110100110000010000001000001010100100000001010000100100011001010010010010000
00001100011001001001000100000110001000011101100110000111101000011000000100010000000100000100100010100
10000101100001001000001100001001000010000000000011000000000100100100000100000000100000101000101010010
00100010000000000101100001000001000000000100100100000001001000010000100000011110100001000000001000100
00001000000001000111100100001100110000011000000100000101011100000000100000111000011000100000001110100
00100001000000100010111010001111000000000110100000011000100110011001011011100000000101111100010010100
00011100100110000001010000100001000000001000111000100110000110010001001000001000011010010000000000000
10010000001100010000001110000000000001001100100000001111000110000001110010001001000110000110000010010
00011010010010010000100001001000000001100101000001010000000010111010010110110100010100011010001100000
10000100101000000110110010100010100101000000110100000000100000000001101001010101100011000000100001010
11000000001100000010100111001010111000100100010101010100100000101001000100000000111001010001100100010
00000000000000001000100000011100000110001000001110000000000001110000100000100100011100011000001100010
01000100100000001010010100010000110101011110011000010000001000001010010001001001000000000011010100000
00000010000001110001101001001110010011010101100011100001101000000000010000101011110001001010010100000
10000000000000001100000111010001000010000100011001100000010100000100000000011000001000010000101001100
00010000100001000001000000001011001010000010001001001001000110101001011001010100010110100001110100000
10001011000010010100101111010101100000000000001111000010000000000000010001110000100000011010001000000
00101000010010010010110101000000000000100000011110001001000001000001000000010010000000011100000010010
01011010001010010010111010001000001010001000000001001111100111000000001010010111000000000000110000100
00001010100000000000000001010100100100010111000110010010100001000000100001000000011010011000000000100
11101010110100011001100010010101000001010001001000000011110011001010100100010100010010110110011000011
00010001100000000010000000100010110100010101010000010000010000011000001001100110000010010000000000100
00011110100000100000011100001000000000010000100100101100101000001010100100101000001001110000000000001
00010010001110000001110011001000110000000100100101010010000010110010001001000100000001000011000010000
00101101100000011000011100000010000110000110001110100000000010000000000001000000000000010010100010000
11101000000000000001110001010010010000000010000000010000000100010010000010000010100001000000000001000
10000001100000110111000110000000100000000000000000011010100000001001000110000000000000000101000000100
11000100000001000001100100100000000100000011000000101001000011000000000000001010000100101000001111010
00010010000101000010100000010100100011000000000110111001000001010000000100000001101100010000111010000
00100011011000000001000000000111010001100000000001100011010000101000100000000100001000000010001010000
10101010101001110010001000100111101101100100101000000000000010000100110100010010111001000010100000000
11000010000100001010010010100000011011000000000011010100010101010010001100010010100000110011100000000
00010101100000010100001001000000000010100000000010010100010100110110000000110100101000011111001011000
00000111000010000010010000110011000111000101101000111000110100001011000010000110000101000001101010001
00001100010110110101000111000000010000010000011110000001001100010000000101100100100010000000011010100
11000011101000011010010000000001100101000110110001000000010111010011000010010010011001010100000001000
00110010001100000001001011000010100001000010000001001001000000001000000101010000001000000010010001010
00110000010000000111000000000000000000100000000101100100110000111010000101000001010110000110000000101
01000100000000000101001100101010000111001000110011010111000001100000100000000000001011000000000100100
10110001011100010001000101000110000100001000001000101011000100000101010011000000000100010100000100010
10100101011010100110011110000000001100111001100000001100010001011011100001100000001100111000000011000
01000100100000011010110000010100110100000100001010011001000110000100100100000010000010100001000001010
00110000101001010000010100011100001000100000011100100010000011010000001100110010000101111001000000001
10000101000010000000110000111010110000001001010000001000010000111011110001001011011101001001010010101
01011001010001000011100001000001011000011000111000100010010000001000001000110000011000000000010101101
10011000010110000000010001000000110100110010100000101000011100100111111000100000001100000001000111011
00000001110101000000000010111000001001101011100110011010100110000011101100000001010100001100010100100
01100000010000100000001110001000000000000010011001001101000010010000010100110000010100000000000000001
10010100001110111100111000000100010110110111000000001110000000100101110000110010000000001111000011100
00100000010001100001100000000100001000010001010001000010001000100000101000101010000110010010100001001
00000001100000101000100000100100100010000000000100101010110100000000000010010110100100010111000110010
10000001010011100000000000100001011010011010011110001000100000001010110000001000000000100100100100110
00000000000101010000010100000000110000000101011000100000000101000000000100000111101011000000100000011
00110000110000100000000101000101000001001000001011000100100100010000010010000110100000010110010100010
00000000110000100011010110000000100001001010010010110101101000010100000000100001100000100100110000011
10000100000010000000000000100111000000011111100101010010010000001000100110001001100000000100101110000
00000001101010110110010000100001100011110100000011000000111000001001011100100101110000001101000010111
01000001000100100100100010000001100000000000000001110010000011000001000001100011001100110110111000101
10000000010000001000000110000100011000001100101000100000010000000011001000110100101001100011001010001
