93 24
69 18
00000000000010100000101010010101100001000100000100010001001000010000101100011000100000010010001110100
00110100011000100000001100101001001000010000100010110100100101001001000000000001110000100010000010110
01010101100010000100111001101101101100010111000000100000000000000100010010001000000011001000101100000
01000000000100001010101000010001110000111001010010001000011001000011100100000000111100001011010001110
00000100000110010100110101000000000000100001010000010010011001001011100010011011000100001000000100000
10110000010010001010001110010000000100000110000000110000010001000010001101001110000000110000000000100
00011001000010000100100000010000111001101100010001100101000000000001010110110011101100000001000001100
00001000010000001010101000011100001000000000000001000000000000010110000101000000100000110001010100001
00000000110010100000000100000001100000000100110010010000000000010100000000000000000000010000000001110
00001000000100000000011100100100110000000101001101100110000000110110001110001010010110001101100011000
00011011001110000000000110100000000011000000100000000000001100000011001000000001111110010100000010011
00100000100010000001000000100110001001100100101000100010000000000101000100100000001001000000100000001
00000000001000000001010011000100001000101110011001010001100100000001100000000010101010110100001010000
01001010001000100101001000010010010010000000010100000000001010010100001010011010000000001100000001010
11000101000000100000100010110000010000000110101001000001100001001100001001001100000000000000100000000
00011010000001100000110001011000000001010110010111011000010110000101000100000000000101000100101011000
10010010000000001010000000001000110000100110100001100111000011011000000011000100000001000000011000001
10001000110110000000000101001110000001010100000000111010001000000001111000000010100000100001000100001
00110011000001011100000100010010000000001111001010011100000001000101000100001100010010000000110010001
00000000001000010000001100000000001011000000010000000000100100011101000000100000000000000010101001000
11001000100000000001000011000110100010001000001001000000001011101011000000010000010100000101110000000
00100100010010010110011010000010000111110010000001000110000101011010000011000011010000000100000001000
00100110110000110000000110110110000100001010000000001001010101100100011100001100100000101010011100000
00001110000000000000110100000000000000111010010110010000111010100001100101001001100011000000001010111
00100010110100111101001110100111100100000100000010100100101000110010010100000101010001010000000000010
01110000100000000000101010000101100000001011000100001011001000101000000000101010000010100100000100000
00011011000010101100010000000010101001001000000110000000110100100110100000000110010111100100111011000
00010010000001010100000000001000001001010110010011000000100001100110110011110110001000010000000001000
00001100000111111000000100000110000001000000100101100011000100001101001000000000010000000000001001110
11100001100000001000011001111001000101010001000000110101000000110101000001000011001101010000000000100
01101000010000100100100001000100000110001010010110000000100000001111000000100000000101100000010011010
01000000110010100100111101000011000000010100100001110000000010001001100000000000110110111011001110010
00100100100111010010010000001000001101001100111110001010000100000100001100100000010101000000001000000
11001001010100000001000100100000100000011100101000000110110100100000001110010110000000000001000110001
00000000001000010111010010010100001100000011010010101000100000001000010010001010000001000000000101010
10000000001000001000000011101000000010100000101001000000000000010101000101001010000011000011000000000
10000001000000000000110010000001000000000101000000000000000000000100110000000001000101110000101000100
00001010000001000000001100100000010010101111000100000001110100101100011001001001010010001100101000110
10100000010010110100100000010101101000101011000000110101000010000110001000101100101000110101010001001
00101000001010110000000000000000100100000000100101010100010100100110110001010000000111100000100000011
01100100000101111000010000101100000000000000000101100001010000000000000000101000111100001010110100100
00101100110000001110100100100100000101000100010100010010001110000110010100000110010010010000100000100
01000010001000100000100111000010001000000000000110111000100100010000000000000011111110111000010001101
10000111001100010000010011000000000011001101010000000100001100100000111010110100001001001000100000000
00110000000100010001110001000100000001111010001011000011000100000000010101000000000000101000000010000
00011000001111101100100001100100011011110010001000000011100000011000000000010010000110010110001000001
10110010000000000001000010010111100100000000001100010100000001100100010000001011101011000101000110100
10000000101000000100100000010010100011101000000100011000000001010011100011000000101101000010000101100
01010000001000000101100111000110010000000000011000011011000000010011000000010000000000000000110000100
01100001000000010100010001001000001000010010010000000101101000001000000010100000101100000000011000110
11000110100000101000011100000111000011000001000011000000011001001001001000010000100011101000001000100
01000011011101010110110010101000010110000111000000011011000101000000000010000100100000000001000000001
10000100100000000010011000001010100100100010100011000000001000010100101000000110000000000101000000001
00000000010000110100000000001110000010110000000111001011100000000000010100100100000111100000001000001
10001001010110001010110001001101110000011010100001000000011000010000001000101000101001000010000000000
00000100000100111010000100100000100101000000000100000100000110000000001001000100001000001001010000111
00000000100110100000010011100001000000101011000110011000011001100100110010000010110000100001001110000
10000101100000001000100110101011111001100000001000100000000010001000100100001100000100110110010100100
01000101001001010001010000001100000000000000100011000100000011000000000000011011010110110100001000001
01100100010000010010000010000101100001011010010100101010001000110101001101000100000000010111100001000
10011011100100000011101000001100001101000100011010001100100101010001001001000011011001001011000100000
00001000000000110000010001000010001001010001000100100010011000000100100010000010000001101000000000000
10010010000010100010010001011000001100000001000100110101000110010100010000000000000000010000011100010
00001000000000000001100111100100110010111100101110000100011000000101000001011010101000000101000101000
00000100100100001100101100000100000011010000000001001010001000000000010000100010011000000001000111001
00001011001100000000110101001011001001100001000000000000010001011000000001000100000010010100010010100
10111000001100111011111100000000001000000110000000000001100001100000000000011100110000110111000000000
01001000000000100000001000010010100100000001100000000000001000000111000010011000001000000000010000010
00001100010010110111100100010000100110010100100000111001000000101111000000011100001110000100011101010
11000000000111000100000011111010000101001100110100010001000010100001001100000000000101000100000000100
00000101100000000011100100101100110101110001011011011000010000010100010000000000000100101010000010000
01001001000000101001100011000100000100001101000110000100010011100010011000000010100000000010001011001
01000010100010100110000100000001111011100000000001100000000100001001100010000100101011000000000000000
10010100001001001101000000101000100011000010010001000000111110101010011100010000010000000101000101000
00001100000011100000000011000010001011001111001001010101001000100100000100000000000100010100000001101
10000110100000100101101101011000010010010100010001010100100101001101001000000010011001000100011101010
10001000001100110010000000010011000111001010000000010000000010100110000000100110001001000000101011001
01100111001010001010000100000001010100000000010101001010001100100011001000000000101001000110011100110
00100100011000111000010000000001000010110101000000001000000010010000000010010000000000100000100100010
11101100000000000100000110101011010001010000010110000000001111100100001001010000101010100100100001001
00101001101000100001010011010010000000110000000000001000001001000010000000010110010100000000000010000
10100010010101100001110011011011000000010010100010011000001000101010101100100001001000101000100011001
10110010000000100000000110000010000000101000010100001010000110100000000011100000000000001001101100010
00110100000100000001000001110000101100010000010010001000011001010000001110101000110000110100101000000
01000000110100001001010110101010110001000000010001100100100000101000001101000101000001001101101011100
00001000011110110100000110001000010110110100010010001000000010000000000010000100001010000001101000000
10100010100010010010100000000110000000100101000000011110011101000001010000011000000101000001011010000
00100010000000000001001111000000101000011011010111000000000110000110010010000000000100101010000100001
10001000000000001000000111100111000110001000001000001100000001000000101001110001000001001001000110001
00000000100100000000000100100010100000011000100000101000010110010001000000000001000000001100000000111
01001000011001100000011000000100100000000011001001001110000110000101000000011100010000000110000011010
00000000100000010000000000000000100000000010010000100001000000101100000110100000001010000100001101000
01000000000001010100000100010010001000100000001101011000000010000000100100010011011010000011001100001
01100000010000000001100100000010100001000010100101100011110110000101000001001110010100001010110111010
00000100011001100001000001011001100101000011011011000000010011111111100100001001000001001100000010101
01000011101010110000001000110111001100100010101010010111000100000010000100010001110010001011000110100
00111101010100011001001000000110000001100010000110000010100000001100001010100000000101100100000100000
00001011011010000101010111001101001001000001010001001000000100001010000100000000010000000001001010000
01011100010000100010010111010010010100100001000000000100100000000000100100000011001000010100111101010
00010010001110000000001000001001101001011100110000110000000010111100000000000110100000010000000001001
00000010000010000001001000010000000110101001100000000000000010001000001001000100101100100011100100110
