63 59
37 21
00100000001000011100100111010000101000011001000001101011010001000000000000000000000000000010100000000
00001111010001000000110100100011100000011000000101000000100101010000001010000001000001001100111000001
00001000000000000110001011000010000001000100011010101101011010100000011101010010010000000011100011000
10110011000001100011000100100001000001000000000101101100000001110000100001000000110100010011000010100
11100101000111000001000100111100010001111000000010010000010001000000000100100000000000000100000101100
00110010110101011100001100010000101001100110000100001000010100000000001010100001001010100000111110100
00011000100100010010000000010010010001011100010101001010000011001001000001010101100000000100001011001
00010010100000010000000000000100000101010010001101001001000111000010000010100001001000000011000101110
00010011000011000000100011010000001000010000000001010000100101000101000000000011011010000000000011100
10011101110000000011011100101000010000010110101101000010000001111000000000100010010010000000000000101
01110010000110001001001100101100000000101100100100000110001001010000000010001000000010111001010000010
01110010101001001001000000010100000001100111000010010000000010000100000010010010000110010001100001000
10000000000000010010000001100101000000000000001000010001000001000010101011010111001011110011000011101
10000000101101001101101101001000010001100000001001010010010100110011010100000100100101010000000000000
01000000011010010010010010100010000011000000110100000000001000001110000010000110000100000100010001000
00000000000100100100100110001001000000001000100001000000010101000010000010100001000000100100001101000
00011000001011010000011000100111001100000000001000000000110000001110110110001010110000000000100110111
11100000000100001000110100101011000000010010000000001000011000000011010100000011001001001000100010000
01010000000011000100000010001000000001000000000011110101001000000001000010110001000100011011100000000
10100000110011000011001110100000001000110010110011001100011000010000000001000011000010000000100000000
00010100000100100000010000000010010000011000000000010000000000000001001110101100010000100000111100100
00100101001000001011000000101110000000010001000101000100000100000110000010001000000000100001000000001
00000010001000010011010000110001000011110001010000000000000100011001100100011011111001001100000001000
00000101010000011000101001000101000000100001010110000001011001001000000000110110001001000100011100010
01000010000010000100000000010100001100100101110001000000000110000011001000010000001110010010000001001
00101010000101100101110000000000101000000100001010000001000010001000110011100001110001110000000000110
00000000000000000010000111100000010000000100100011011100001011100010000000011100010001000001000101010
00000001010000000000000100010001010111110001000101101000100011100010110100000010011000000001011000111
00100000110100101000000000000101001000001000110100110010000000100000010001111110000000010000010011000
10100100011100100101010011000001000000001100100000110011001100000001000100000110000000001001010000000
10000000100001111000100101001110000001000010110011100100000100000010001100010000001010100100010001000
00000000010001000100010000010101010100000110100001001011010001010000000100000100101000001011000001000
01000100101100100000000010001000001001001010001000100110001100000000000010100001110010001000011000101
00100100001111000000001001010000001000010001100010100000001010010000100000000100000100011000100010010
10000101000000000111010000010000000001000101000000000010010100000100101011001101000000001110000101110
01000011000001010001000000000001101101100001010011011000111001001000000010000001100000000000001100000
10111001010001100000000000010011010000000001101100000001000000000100101000001100000010110010101000000
01000110000000100001100101001010001100011100110111001001000110000010100110010000000010000000000000101
10100100100011101100010000010010010010000001001011100000000101000001101000000010010000010100010000000
00100000000000001100000101000100010011000000001000010110001100000010001001010010101110001100000000010
00100101000011110000100100000000011110001000001000000001100000000010110101001010001010010100001100000
00101000101100000101011100000101010010001101000001100001000010000100010000110100010010100000111000110
00100111010000100100000101100001100010001011101010010010000000000000101001000000001001010001011110000
00100100000000000010001100001000000101010000110000000001000000100101000110111001000100001100100101100
01110000000000001110000001010101110101000001100011000101010001000011000100010001010000010010010010100
01000001000100110010110010010100000100100000010010000100000000010000001000000100101000100000100000000
00010001000001100010000000011100010000000011000110000010000101010000001110000110110100101110101100001
11011100100100001000000100000001101100001110000100011000000000000000000000001100011100001000001110011
00001001000100100100010000001010000110010100000010001010000000000010000100000000101000010101000011100
10111101001001010000110101001000000100010110100000010000101001011010101000000010010011010011100001000
00000100010100100010000000101001001000000000100100101100000010000101100100111000000000010000010000111
00000000000000001000101001000000000001110010000001110000011100110101011010001111010001000000001000001
10000010001101010010100100000010000010001101000101000011010000001010000010010011000000000000000011001
00000001110110000100001000001010111111001011100000000000010001000000110100000010000111000010010000000
00000110000010110100000000000110100000000100101000000100010100000000001100100000010000011001001001000
10111001001000000100011011001000000011000110011010100100000000011010000000100100101000001011000100000
00000000011010001001000010010010011001100011010010100000001000000010001101010001100000000000000001000
00000001000000001000010011000000110010011010000101001000100001100100000000101101010010001000010111001
10000110000011101000000000100000010010001001100000100000010100000000000101001011010000000110110101100
00010110001100100000110000000000110101010001000010100101101010100101101101000100010010000001000001100
10111000000000000001101001100010001000010000111011000000011001000000011110110101000000101000100000011
01101111000100101100000001000001000000000101000110000001101010110011000010010100000000110000100101000
00001000001100100100000011100101100000011111000000001000100010000000011010010000000001000110010010000
00100001010001000010000010011010000010100000000011000001001011100011001001100010001001010010100000010
10000100000011100100000000000101100010101001010011011010000110100000100100000110000010001101010110000
01001100001100011100011100110000100000100001000100001001000000001110000110100000100101010000001101100
00001010111100000000000001010000010010100000000011100111000010100000101011100000100011011000100010100
01000000000010001000100000000100010101000000010101000000100100100110010001000110000010011000101010100
01101000000110001010101011100001000100010010000110000000011000001100000100101000100101110000110001001
00000000110000001100000001110001100100110000101000011000010000101000001000100111000110101101001010010
00100011000100000011110111000011010010001000000001000010001010101000000000110100010100110000111000100
10011000000100001101101001001001000111100000000001001000100001000000000000000100101001000000000000000
00000000000111001010010100001111000000000100101010011001111010000010010101001000001000010001010011000
10010000000000001011001000001011000011000000100110000100010000100010000001010010000000000000001000000
00101100100000100011000000001100000011000100010001110011010001110111111100000000000010010000000000000
01000011100100001100000001100011000000000101000001010101100110011001000011010100101001100001000110110
01000100000000000000100000010100001000000010010000001100010010110101001010100000010000100000001010100
00100110110010000000101000000100000001100110000001010001000000010001000010011000010101001110000101010
01011001011110010101010011110000101010010000000000001000000100000000001101110001011001001000000100100
00011010010001100000000010001100010000100000010000001101000000100010000000000010101000000010010000000
10100000100100011001000010110010010000010000010000000010010101000001110000011010110000000100101010011
00000000100100011110010101101000110000000110001000000100110100100000010110000000110101010001110000100
00000001000010100000000010100010000000001000000000001010100110000101110011011000110000001000010010000
00001000001100101110100001000010000000000010010100001000010110100000010001010101000100010000001000010
00001001101010001100111001010001010001001110011011000110001000000000010000010000001100000100001100100
01110000101001000001110000111001001100000110000000100100100100101011100010010010000010000010000000010
00000100001000110111000010100001010101001000000100000110000011000110100010000011010110011011101000001
10000101001100000000100010010000101001001000000011010000000000010000100010000000000000001010001001000
01001010100010100010000000010010100101000000000011000111001000001000111110100110001100010000100000011
10010000000000100101000010000110010110001011101001101011100010001100100000000000000100000110000000000
01000000100001100000010000010001000101100000000011000000110000100010101000010000000011010010001011000
00001000001000000010000000000001101101000111010000000111000000001100001000010101001001100011111000000
00000100000010000010001100000001000000100101000001001000010000100000100000100000001110011100010000010
00100000100010000100000001000101000100100110000101011000010000000100000000000011000100000001111100000
00010000000000000000001010000001001000000000011100010001000100000000000110001100100001110001100000101
01010010111000000000100010110010000100010000100001100000011110100101011001000000000000010001100010100
00101000100000010000010010101101000010100111010000100101000000011110000000011010100000100001100011100
11000110011001000000010000000100101001000000101000000000111001001000011011001000000000010010100000010
10011101011000000000001010000001001001010110111001000100000000000000110100000001101001000000001010011
00100010001101100000000001010000001010011100100000100010000000000001000101010001010100100110010000001
11000000010110101100101001001000000101001000011001010001001110000100000001001010000010010011000010000
