8 83
61 8
10001011000010001000100000000110100010000000101010001000000000101110010010001001000011010000000101010
01100001110100000101011010000000000010101010101000000001100100000000000110000000100010001000100010000
00010000000001000000110100000101001001010100010000000111010011011001000001010110001000100001000000100
01101000101011000011100000000101010100101001001100011001010011000000000001001000100000100000000110000
00100001010010001000000000011100000011001010110010110100001010110000000000010100001011100000100010000
10001010110001010000001001000111000001000000000010010010010110000011000010000101100100100011001001011
00100001001100001101000000000100000010110000010101101010001000010110010011100101010000000011011000100
10010110000010000111000001000010000110010110111100011001000000000100001100010000010000000100000000000
10111010010010110000100001000000001001010100000000000000100000000000100101000000110000001110000101010
00001000000000000100000100100001010110101010110000000010000000010011100000001000100000110000000000111
00001000000000001000100101000000100000100001010001100011000100010010001001101110001000000100101000101
11000001000100000000000010100011111000100000000100100010000001100010000100000100011000000000010100000
01100101010001000000110001110000010010101101011000101001000011000001100010001001000010110110011000101
00100000111100101011000101000101001000010001101000010000101000011010100000101000000100000010001000100
01010000001001001010010101001001101100000100101100011000110011101011001111010100000010101101000010010
10100000010010010000000000010001000001001110001011010100010000100110001000001100001000000000000000000
10100001001101011000011001000110100000011000001001001100001001100000000110000100111001110110000001000
10010100000110110100001001100000001000100100011011010101010000100000010100000010110000000000010000000
00010010010111010010001000001000101000100101111001100000110000100001101010011100000001000000100010000
00000000001101000000001001101000110001111010001001000000001000000000010100100001101100100010000100001
10010101001000100000100010000000011101001010001100000100010001001100000111001000010101000000101101010
00010110000010010000000010000011000010101000000001000000001111101010000100111000010000000001001001010
00101000110000001100000010000101010010000000011101010000100000001101000011000100001110000101000100111
10001011000110110010101100000001100000000000001000110111100010001010100000100100001000111001000000000
00111100000000110000000001000010000100011000101100001000100010011011011110010100111110010001100100101
00100000000101001000100110111001111000010100011000110001110011000101000100111100000100010011000000000
00000000000101110011100101000101100000100100111010001000001101100100010001100000110101001001000110000
00100000010000000011001100000100000010100001000001001000101000010000000100000000000010000000011100101
00001000000011001011001000000011001101000010000011000100000000000000010000000000000000010000000001001
00000001100010000010000011000001110010100011100010110000010010000000011000000001000010000010100011010
00001001110010100011000110010000000010001010010001101010011010010110000010001000100001101010001100101
00100100000010101010000010001001100000000001010110000100101010100101000100100001101110010110101010010
10000101000101010000011011000101000110001100000000100000100011011110110000001110100010010101100000011
10010110100100000000001000101011000101100000001000101000001100000001100000001010001010101100000011101
00000000000111010000110010000000001000011001110100100000011001010000100000010110010100000000000111000
10000000000001010000100010011000000011010001001100000001001010010001011101011010000100001000000000000
00000011000000100000010000000000001111000010101001110110010000000000001010100100100110100000000111100
00000010000000000000001000000110100000001010100100101000011101001000001001101001001000100110010000000
00111100110000101000000000000100011000100101000011011001100010110000100000100010000100000100000000000
00000000101000000000000000001000010010011011001110100110110010011100000100001010001101000011000010011
00100000000011110100100110110000000110000100001100101001001101110000001001000101010010100010001000000
00001000000001100010000111000001001001100000001010100000010010010000011011000000000000000011110101000
00000000001000001010000000100000000000010010000011000000100010010001010110001001110001000000001010001
00100100101100100011010100001000011100010001100000000011010001000010010010000000000011011001001101001
01010110000110000011000000100110000001010100010011010010000010101000100001001011010011010101001010001
01101001010010001011010010010000110100000001101001000011000000000000001100110010100010100010010010001
00010101010101000000001000000000101000000100001011011000000001001000010101100101000010000010101001100
00010111011101000000010110010000001010000110010100000010001100110111001011100000100000100000001101100
00101000010000100001100100001100000110011110110001000100110001000001111100000000100010001000001000100
00100010011000001001001001100000001110100001100000111110000000001000000001010101101000100001100110100
00100000101000100010100010010010010000001100001000010001101100001010011000100000100110110000100000011
00000000000100010001110000101111000001000000000000100100000010100010000000000001000000010001001000100
00010001000001100000000100011000010010110110001110001011010110010011000010010100100010010110001000100
00000110100101100001000100111000010100000100000000100100000011100001100010000000010011001100100101001
00000000000000000110010000000001000000000010101100110110001011001000110101100001010000011100000000010
11101001001010001000111010100000000100001000010000000010000000001000010001000001000010000101010100000
00000100110111100000000001000011010000110100101000001000000100000000000011101100001110001000101100011
10000000001100000001100000100011000011000101001111100000110100111010010000000000000000100101001100000
10010100110110000101000000100000110000010000000111111101000010010101001010010110110001011111001011001
01100000000111111001000001100000001010000000010000010001010010000010011000100100000000000000000100100
00000001101000000001001000100000011101010000000011000011010000000000000101001000101001000000001100110
11100000011100010000011000100000100101001100000111010000101000000011010110000100001010000110110100010
00100110000010000000100000000011101011000000010001000100010000010000100110001100100000000011110011100
00001110000010001100000001100100011000010100000000010010010110000001100110001000000110000000001010110
01000010010110100001010001111001001110100011000001101000000001100000010000000000010000010100010001000
01111010010001000110000100000000000000101101001110000000010001110010000001000000010000010000001100001
10000100001101001010010001110100001101100000001000001010001000001010100000001010000100000000000001110
00001000010011000101010000000000010000110000010011000001101000010110001011101001000000010000000000100
00001111001100100000001000110010000100011000010000000000101001001010000000000000000011001110111001001
01000100011000001000001110000010100000101011000100001001000000000100000010010100100001110010001000000
01000100110010001100101011110000001001001000000100000000000011000001001000100011000000001000010111000
00101001010000000100001001000000101010000011001000100010100010010000010111001000100001001011000000000
10001110100001110001011000000100000010000001010110000001000000000000111000101100110110000000000010000
10001100001010000000010001100100000110100000000010100000100011101100100010101000100010100100001001100
00001000000100100001101000000000000100100101111011000000000000010010000000101000000000000100001110101
10000000100010100101000100001000000100101100000000011011000000100010100000111010000000101011010110101
10000000000101011000000000100001001000010001000010101010111010000001000000000000100000000001110000000
11000100001110000011101001000001011110011000000000101011100011000011000001000000100000110001000101000
00000001000001000100111000000100000000001110000000000010000000100001010000100010000001010000010000010
10000100010000010000001101101000111010111001010101100110100011000100000100110000000010110000100011110
00001000000111010010000001000001000000101010100000100001000100000001010010000000010100000010001001010
00010100100100000000101000001101000000111000000001000010000101000101101000101110000001000101101100001
01001100000100100100000001000001000001001010000010000000000000001100000101100001100000110100001000001
00010010000001111000000000001110010100010110001010000101000011000010001100010100001101000000000101000
00010010110000000001000001000110100010001000010000111010000100000100010010110101000000001011101101001
00000000000111010000100000000000100010100100110001000011000000110011100111000000001000000001000000110
00000000100010100001011001111100010001101001000100100100001000101100000000000001101001001010010000010
00000000001101011100101010110000110100101010110000000101001001010010000010001111000000011011000000000
00101000101000100000001000000010001001001010011010000100001001000100001101000000010000000000010100100
11000100000100000000001100001000010101101101000000000000000001000100000010000000010000001000100011000
01000100000100000000010100010101000000000011000000010101010101011000010100100010010000100100010000000
10010110011000000000100000000000011010110000100100001011111001001000000110000000101001000100011011001
00101001111101000010000010001100100011010011000001111000000100000000000101110001000100101010000011100
10100001100010010010000000101100010011010000000011000010001000010110000011000010001001010010100000000
01000000100000000010000001011100000000011001000100000000000000010000010100001000000000000011000000010
10000010001001100000001000010001001010000100001010001000010000001010000001010110001100001011101001010
00010001000000010000000110100000011100000000110000100100110000000010001101100010110010010010011000000
01000110100000111110000001100100000110110100000000001001010010100100101011000000000011100010010010000
00001000001100100010011101011000100000010000000010000010010010000010001101011111010000100011000000000
01100000001010100001010001000000000001010011100001100010010010101100000100000010100001000000001100010
00000100100010000000100000001000000000001000010000100100011100100011110010011000100010100011010110000
