87 38
12 93
00010011001000000101010000000000100010010010011010001100000110000000100010011000011000010000100010000
00010000010000000000111010000010110100100100001000010000101100001100101001000110101101001100101110101
00011100010000100000001001000001100000001000110010011011000001100101111011000101100111100010000010001
01000101011000001011100000011000110101001000100010010100101110010001001010100001000000000010001110110
00000001100010010101001001101000000010011010000110000111110110010010101000010000110011110000011001000
00100000110100110010011000001001000011010100010000010110000100001001101000001100000100101000010000000
00100100010001100000110100100000100100000011010100000000110000110100000001010001111010100111100100011
10100001111010010010000110100000111100000100011110100100101010000010011010111100000101000110100000101
00011000100000100100001000000011110110000000000001000001010001000001101011000001000000000010101111001
00000010010000011100000010000100000000111100000101000001100001010011000000000010100000010010110101101
00000000100010000000000000101010010001010000100001001001001001100001000001010001000110000110000010010
01000100000100001111110100000000000000000111001000001010001001010000000010100000001001100000110110110
10011000000000101100000100000000000001000010010100100000110000000110011000000000101011010000000001000
01000010000110001000000000010000000101000000001010100000100010000100100100001011000001000101000000000
01110010000011100011110000100000001000010001110101000100001000010101011011011001101000100010000011011
01001000000011000000011010000000100100100001010011001000100010110010001001010010001000111110111000000
00100000100101100000000010111100000101000010001000000101000110101000100000010000011000010000100011010
10000101100010111000101010000010010100011010010010000010010000000001010100000000010101011001000001010
01001000001110100000000100000000010101010110000100110000000000001011001101000000001011000000010110010
10000000100001000000100000100001000010110001000011010001000000101010000010011100000100010110101010000
10001100111010000110000100000010000001001000111100000011000000000100010010000001000000101000010010100
00110000000000000000000100010000001001000001000000100100010010100101000100000000001100111001010010000
10001001101001100001100000100000010000100000011000010000100010110000011110010001000101001000100100011
00000000000000000000100100000001100010000001000100100010110101010010000001010001000011100000011101100
00010100001000101100110010100000000100001000000011011011100010001100000001000001100010101001100100101
00010001001010000000100001001111011000001000010110000101100110110110011000010001010001010001001010000
00010010101001000001000100100001010011110100100100111010001101000011011000000010010100011101000000101
10000100000000000010100110010001110100000001011001100110011100101000011000000100000010100100100001001
00010000100011000000011001000001011010001011110000001001000100010000000000001000001010001000000000100
10010001101100101100010101010000100101110000000001111001111000010010001110001000010010110000000010100
10000000000000101011001000000001010011000000010000000010100110010011000000000110000101000000111010001
11010010000011000010000100100000101000000001010000010001011000000011001100100110000100010000110100000
01100001001100100010011011000001010101001000001010000011000000101010000110100010001110000011010101100
00010000000001100000010110100001000000010001111000011000011100010000001010000100101000100000010000000
00011000000010001001101000000110110101100010010110100010000001010110001100000110001100110011110001110
00000001000000100000100100010001100011000000001001100101101000101011000000000010000111001000010001010
10000110000000000100010001101000000000001001010001001011000000110011100010000010000000000101000110010
00100000001001010100011011000101000000110010100000000000100010100100000000001000001100100100001001001
01000000100010001000001000100000100101101001001000000000000010110010000101000000011000010000000000100
01001100000000010011001000000010000101001000110000011010010000010100100000111001000010000010101000000
01000000000000001100001000010000100001000000001101001101100000000000100001000000000101111100110110110
10100000000011000001100001101100000000000000000110000110000000101011101000110000100001001000110101010
01010011000010000011000001011000110010100000101000010000100110000000011100000100000001110110000010100
00000011000011001001101110000110100010001101000000000000000010101010000010010000000001001001000000000
10011100010100010100001001001010100000100010000000000001000001010001101001000010010001111110000110000
00010010100110110001000001000000110100000001011101010000001000100010100010010101010100000100110010001
00000100110001000111000001110000100000000010010110000001000100000101010000000000000000101010000000000
00000110101000010001000101100001000010000100000001000111100010000011011000001001100000010101010000100
01011010101001011001001100100111000100000000000010100100100101001010001101010101010000000001000101010
10110010111101000110110100001001001010000011101000000010000000000010101010011010100010010100000100100
01000000110110010110010100010010101011100000000010001000000000100001000000000001010000001101010000100
10010101010000010000010010000111011000001111001000001010010010010100000010101000100001010100000000110
01000010000001100011010001000101001100100000110010101010001000000010011001000110010001010100010001001
10110100010001010011000110101001010101100000000001010000001100000001111001100001101101010001000000001
01010010010001100110001010010010010110000001100110001110001001000000100001000001010001000011110010110
11000010101001100010001010000010000001000000100110000101000000000000010101000010000010000110001000010
01001000010111001000000101110010000000000000001001010000000000010100000001000100001000011001010100010
00000001010010000000101101010101000100000000000000000000000001000000001000000101100100111000111000000
01010010000101101000100010110000000101000010000000001110001001100000101000100001000000100000000001010
00001000011100101000010000000001010001110100000000101000011100001000001000001110001110101001110100000
00010100001011000000001011111001000101000100001010000011000010100010000100011000000001010001100011100
00000101001000100101010000101001000001010100110100101000000110000000010000011010001100010100000111100
00000101101100100001010101111001000000001111010110111010011110101001010001001000100100011010100000100
10101101101001000011000001001010000000000000000001000100000000010011000101000000011011000011010000000
01100000010000000100000100101001000100100101000101100000110010100001100010010010000101011100000000000
00100100001101110000110000100000101001100100000110000101010001000101000001001110010011000010010100010
11010111000101010010000100000001100000011111100000000100100000000110000010100001100010110100000010011
10110000000010000010001000100000100101110010010110010001001000001000101001100100110000000000000100101
10100110000010101000000111100000000000001010000110001101000000010100000000100011010000011000000001000
10100000000000000000000010000100011000000010110000010000100001000101101000000101000001100100010000010
10000000111111000100110010000000010001000100000001000000110100000001100010100010111100011001110001010
01010011010110010110000011110010000000100000010100001000110010101000100010101100001000111000001110010
00000000000000001000000100100101000000000100000000001100100101001110010000000010101010000011010100000
10101001001000000111010010000000011001001100100000100101011101001000101000110010001000010000100010000
00000101010000101100100010100100010000100100000011000110000001000001000010000100110000000010001110010
00110000001110000010001011001000001000000000101000100000000000000111001011001011001011000001011011101
00001100001001000000001010011000010001000010000010000001001100011100100000000000000101000100010010000
01000010101001000001000000001011101101000001010101000000001010100100101001001010100001000000001001110
10001101001110100001000011110001010111101000010110000100001000010001000111001110000000000100100101011
10100010110000010010100011000010100000000100010001001010000000100000000000010001100110010000010010000
00000001010100101110101000000110110100001010010010100100001101000010000001000001010110001100100011000
00101011010001100101010010001001001000101010100110000010001100000000000000100000001010001010111010011
10101000000000010110111101000000000100000010000010101001000010010000010000000000010100110111000100001
10001010001100001000001010000000101100000001110011001000000001010000000010011100100010000101100000110
01110101101000011000000000000010000001100000000010000111100100000100000100000110010100000001101000011
00000110010000000110010111101000010000100000010000000110000011000000110100111100100000100111000000010
00000000100101000000100001011100000100111100011110000011010010000000111000000001000100000001100010010
01101100000101001010000010000000001000000000000000100101000000101000000010010110000000100000100000000
00001011000001000101110101000001101011100001000000001001001000000000100000100010110010010100110000101
01001100100000100100010000110001011100000100100011000011011000111100010000000000010100001000101100000
01001000110001101010100010100000110100010001000010010010010100100110101100000000000000000000010100001
00010100001000010100000110101000110000000000000101000111011000001001100000001000000010000100111000001
00000000000000000101010000000101000000000101100101011100000000000010100000000011000010100100000110000
11100010111000000101010111011010000010000100110000000110000001000101010100000000100010101100010001101
10100001010110001010000100001110100001000011001000001000000110001000000000111100111000000001000001000
10100010000010000100001000101000110010010100010000110010100010000000011001101001000101000100000001001
10111001000000100000011001000000000000101000001000111000001100100001000011001000010101000011010010000
01000111101001100100100100100010011011010101000001001100100011100111010001000100000000000001001010100
10000010010001000010000100011000110001111110001000100000000100011000000010000100000001001000011001000
00001101110010111110000000010001000100000001010001001100010010011000000001001010010101100010101010010
00101100000000001010010000100000000111001101011000010100000100000010100000110000000010111000001100100
