81 81
47 41
01100111100001101010110101010001001001100000011101100010010110100101001010000010100011000010111010010
00000000010010100001101110001010000000000110000010000010111010001001010110001101100110100000101001010
00100001011001000101000010001110000100011111000011001000100110001001011001010000001000010010100001101
01100001110100100001010010000010011000000000000110100000000100111000100010001101010100001101100011010
00000010000101000000000110000000000101100000000101000100001101010011001000001000010111101000000001001
00010000000111101000001100000000001010001001000110000000010110011110110100100001110000100110000110110
00001000001100100000100001100001000000111000100000000000000001000000000100110110011000000000010001000
01010010000000010110000101010001010000000000100000101100110000010011101100000000000100001000001100010
00001000000101110010000000100001000001101001110100100100101000000010111001000000000010000001000001000
00000100010100100000000001010010010110011000010000100000011001100011000011010011000010011000000110001
10010010000000000000000100000000000000001110101010100000000100000000111010001001000010000100001010011
00100100111000000101010010000000010000000010100101010111000000000000000001000000000101000000110100000
00001000000000010010000010000100000100001000100001000010010011000100001001010110001011011010001101000
00100110100101100000010000010000000001011110000110001101000010011001000001000000001010000001010011011
00100000000000011010000010001101001100010110101101000001001001000110111000001000000100010010000100011
00000101010100001011000100001000011111000011100011010000010100100101011011101001001000010100100000100
00000111101000010000100100011010100000000011001100011000001000011100000000001000110000100001001011010
11000010010101001000110001000011000000100011101100010010101000010010110000000010000001010000111010010
00010000010011010000111000110100000010100010001000101001010010001100010101001001110010001000010000000
10000000101000001000001110000001110001000001101000001010101000001010000011001010010011011010011011010
00001100000010000101011000100000000001001110100010000100000011100001010010101000010000011110110010000
11110011001011000001110000011101000000001100000011000000000100000001101000001000110011000001010100000
00000000011000011010000000010111000010100000000100011000000100001010100000001000011101000010110101100
10000100111000000100000101000100010000100000000110000100110001000111010001101011000011010000000001001
00011100100100000000001010011000010000000100001000000101010010101101110100010100011000101000000001000
01000010001010110101000101100110010000100101010100010000001100001100000011111000001000100000000001000
10001010001100110011000100001001000001000100000011000100011010010010000000000000000000000100101010000
00000000101011000001000010000100110000101000000000100100000100001100001010011010100000000000111001000
01110001001100001000000010100100001000111100000000001000100010000100111011100000000101000001100000000
01110000100110100100010000111100000100000000000010000000100101000001100001000000000011010000000100000
11000010011000100000001000000100001001011001000000010011000010101101111110101000000001000011000100010
10100010000010010000011000010000001000001000000000010010000011100000000010010110000001111110110000101
01100000001000010111000011001000010001110001010100000110001000001001100010010010010001000101001101001
01011000100100000000000010010100110000000000000110001001101000000000100000010011001110101100001000001
01000000100000100010000110001010011110101000000000111001001000010101011000010000100000010010000011011
10000000001110110100000010100010101000000110000001110000010011110010010100000100100001000010100101000
10011011100010100010001001001001000001010000100010011001010100010110110000111000100001000110000000010
00000000100010000001110100000000000011100100000001010110001100011000110001000001001010001000000100110
00111011100000000010000001100000000100110100000000000001000111010110010000000010100000000000100000110
00000010100000110001100100010010010010000001001010001100100111000100010100001110001011000111000100110
10010110000100000100010000010110011101100000100001010000100100000000010101010101101110100001011101000
11001110101110000100100000110000000011000001001100111010000000000000011010011000001000101110010011011
00100000010001001001100001011000010001110100100110000010100000101110100101000010100001100111000101000
00000011000000000000001100000110101000001010101100011000010100000001000001000100010100101000011110010
00000010000111000000110001110001001000000001000010110101000011000000110000000000000010010000000010001
10110010110010010001001100100010010000000000000000101011000000001000010101110010010000001001001000010
10000000000100110010001010010100110100001100001001010000010101010000000000000010000001000000010001100
01100011110000000000000010100111000010101001000110111101111110100000001100000011000001010010000000011
01011000010001010000011101101101100001000001101100000100100011000100010010100000011000000000010000100
00001100000010011011000000000001000100011000010001100110000100000000110000000001000101000000100000011
11011010000000001000010100001100011100100001000000100110101000000011101010001110001100000010000000010
00000010000010011001010000100000000000000001110000010000000010001001000100000000010010110010000010101
10011000010110000000000101110001000010001100100011000010010011000001010101010001100001100100111000110
01011000000000011001001000000011011100101010010001100000100000000010100101110110000011001000001000100
00000100011010001000001000110001110001001000000001100100001100000100000001101010000010101001100010000
10100001010101010001010100101000010010010110010100000011100100000000001101000010101000000011000001100
10100100110001000001001000000000000000000010001000000000100010101000010100110000000101011000010010000
10000010101000000100100000000100001000001000100110000001000000100001001010110001100010000010100000110
10110000000000100001000011100110010000000100011000011000010100100000100111000000000111001001000000100
00000100010110101000001001000010101100100100011010100010001000011001110000100110100001100000100011000
00000100000111100000000000101110010110110001000010000000000101100001011000001011000011001001001000000
11101001010001001000000100000010011001000010000000001001000000000011100110100000100001001000000010000
01001010000111001000001000000001100000110100001110000110101001001000100100000000101011000111000000011
10010110000001000111100110101001000000011000000000000001010010110101100011101011100000000000000000101
00010101011001010110000000101100010000100010000001000000000101010001000101000110011011000101000000000
00001011001000101001100101000011000000000001010001000100000110001100000000011100110000000000000110010
00001100100000100110000000000111101100000100000010000100001001000100111110000010001000011100000001000
00100001010000110101100100100100100101011101000010001101010100110110000101100010100100000000010110101
10001000010100000000101010011100100100010001000010001000000110001001000101000000011000010100111111100
10001100000001100001001100000100100101000110101101110110110101100110010010001000001101000010100001010
00010001000010110001101001100000000000011101000000000100001110001011110001000110001000000110110001100
10001001000010001100010000001100000001110010001011110001011011010000011001000000001010000000001000010
00101001000111011010001000100010100000001101010101000101110000110000000000100010010110001100001001001
00000000110000001001100001000110001110010000110010111010000010010001010001100010001000000101001100001
00000000010101111001000101010000001110011001000100011010100000000001001010100001000101100101000101010
00110000100010000100000101000001000000001000100100000100000000001111010001000000110000100000000001100
00001010000110010110000000011001100010100100010110100000100001010100110010100000000000110101010000001
01010001000011100110010010100010000100001000001111100100000100101110101000100110110010011000110101100
01000010010000000110100100001001000100000010010000000000011100000011001000001000000010000100001110000
00001110001010001011001101101101000100000000010110110111010101110000001001000111110100100100010000100
00000011000010010001000000111001000011010100010000010000101100000100100000100001000100000001001101001
00101000001101000100000100101000000001000000000101000100000100111100000011100010000000001000000100010
01100100000000001000000000010011000000000010000100000001010010000101010000110000110100010001001100100
10110001111110101000100110011000100110000000000000000001000001011000010011000011000000101000000100001
01101001101001001001001000101000010111001100001100000000100000100000001000000000100101101001001000100
01000110101000101100011000110101000000100000001010000001000000100100000100000010000000000001000010000
10000000000100001001010000111000001101000001100000011001111010100000000001011001011110110111110000100
00010101000011000111101100000110000010111000110101001101100011101000011100001101100001101000100110101
00000010001010000100110000100001000100100101010000010011000000000000010010000001010010000001100000100
00000010000000101010010100011100100000000010001000011111001010110000000110001010000000001011111000000
00100100000000001010001100100110000010000111110000000000010000000000010010010100101010100010000001000
01100100000010100101010010000001100000011000110000001100000001000011001000001000010000000010100100011
01000000100010101100100000010000000011100000000101000100000010001000001011001101000001000010001000010
01110000011000010101000010011001010000000000000010010100101000101000101010001001000100110101100011000
10000100100000010110000000001010001010011011000010000000010001000101000100101100010110100000011001011
00001000000000000110000000000100001010000000011000100000001001000100011011000100000101110110000000000
00101100011001001000011100011100111000001000000000000000110000110000000011000001100010000101001001011
00001100001100000000000000001010101010000001110000100000000110011010010000001000100110000001011000010
00110000000010010101000100000100000010000100010000011100010000000001010000001000000010000000011011101
00000011100101000100001000001010110000000011101010100100001000011000101101100101110010100010011100011
00000110000100000100100000000100000010100100010100111010010010000100000100001001000000001000000000100
