10 42
77 35
00011000000000000000100111011000001010000100000000100100101000000001001000000001110011000110000110010
00001000000010001000101100101001001001000000010010010010000101100010100010000000000010000010010001111
10011100000000000100000000110010000100010000000110000100001001100110010001000000000010111000000100000
00000100111001110001010100000000010000000100000100010000010000010001100000000010100000100001000000000
00101000101000010000001000000000000010000001001100011010100100010001001111001101001011011100101010000
00101000100000101000001110010000001001100000000100000000001000001100001000001000111010100010000000001
01000010010000100010011000100010000000100000010001001000010100000000100000010000110001100000000000000
01000010101100100001001100111010011100000000110000110000000101000000110000100000001000010000100000110
00000010110011000000101101101001001011000100010000100000010001110100100010000001100000001010000001110
00010101000100000000100001000010100100010001000000000000010010000110010000110001110000100011010100000
00000010000000001111011011010001000100101100001100000101100000000010000100000000011000010000001010000
01001001100000000001001010110000000001000001100000110100100010000000001010101110000100000000010000010
00000000000000000011001001000000001000010001000100000100000010101100100010000001000011010010000000000
11010101001000000000110000010001110010110100110000100110100000100000101001100000000010000010000010000
00101110100001100101010000000010010001100010010101111100011000001001010000000100110010100111000110000
00110000010001010000000100100011001001000001000010000110110011110110101000111101100101010001010010001
10000010000010110010100000101100000100010100000001100001100100000000010100000100000100100001100001100
00001110000101010010010100000000000000001000100011011000010000100010000100000010010001000101010010011
00000000010011010010100000000100001000100000100000000000001001001010010110001000010000000000000100010
00000000000100000100000001001000000101010100101010100100100011000001001100000101011100101101000100000
00001000000000000001010000010100000000000100010001000110110001101010011000001001000000101110010110010
00111000001001000110010001000010010010010001100011001001000010011000100000000000101001001001000000000
10010000100110000111000000001110101010101010000010100111001100001000000100001000011100001100100100000
00011001000100001000100101101101000010001010011101010000101001101000001111000010000000110101010001000
01000000001100111010011000000000010000000010000000001000000100001010000000001000011000110010100101100
00100001110000010000110010000110100100100000100000011100100000101001001011010001010010000001000001000
11000000000011011001000001010100010010000101010000010000011000000010000100100000000001000000000010001
01000110000000001010010100000010000100000001000000000000010001100100100001001110101111001010000000000
00001000000000010001001000010000000101000100000000000000000001100100000000010100001001011011000100111
00001000111010110100000000011000100100000100000010001110100000000000110000000001000011001010000010000
01000001001100000110000001001000001000100001011011101000000000001000010110100101001000001010000001000
01101101101000000101100000001100000100000000001010100110000011010000000010100110010101100011010010001
01000100001011010110010000010000101000000000000101000001011100000101010000101010000010010000000101001
00000010000110000100110000100000000000000010001111011100011110110111000010000000010010100001000000000
00000101001000000110000001000100110000010101010001110001010000010000001100100010001100100000100000011
00110010011110001010100100010000000100000000000000000000001010110001011000000111000000111000100100000
01000000010000111100110100000100000001011000100100000001100000010000101010100000010000000001000110001
00000010100011000001010000100000101001100000101000100001000000000011100100100110000001110000010110100
01000011010000000000110010001100010100010010010101010000010010101111010100110000100001001100000001000
00001011100000010100010110001001010000011001001100100011100110100101000101100001010110010010010000000
10010100000100000010000101100000011010000010000000100100100100010011101010010000010001101101000010110
00001100000000001010001000000011000010000000101100100000000001001000001100000010110010111111010010110
10000000000001000000010100000000000000100011100100100000100000000000000000001100100000000000010100001
10100101010001100001001001000000001000011101001101011001010000100001111001000010010000000001010010010
10100101101110001001000001000110100000001010010011100100100101101000100001100000000001101111000110101
00100010011010011010000100101001101001000101110000000001010010110000001100100000001010001000000001001
00001011110100000000001001000010000110101110100000110000010010101000000011000011101110001000111100100
10000101010011000110000100100000011011001000000000001000000000001100010000000000000101000000000100001
10000010011011000100010001000010010100000101000110101000011011000000100010110001000001010000010000000
01000100000100000000000010110001011000010101101000100000000101000010001101010110011000010100010001100
00000100001101010010101000010000001000000000010001001010000000100000100100011101001000000010101000001
11011101100100100100001010010000010100000100000001000011000000010000000100010000000100101100011000000
00101100110101000000100000001000010100101001000000011000100001001000000000001001000011000010001100000
00100110101110000001000010000001100010011100101010001100000010010000001000000011000000010001001101011
00010101001010101000101010010000000000100100010001000110001000100000000110000010001000000101101100101
00000000000001001011000000000100111010000100011110000001010000011100000000110100011001101000010000000
00110110000000000000010010000010001001000110010100000100011000110000010010001000000100000100000001000
00001000000101100001000000101100000110011100001100110100000010010100011100010001000100000010000001001
00001000000000000000100111000000000100001100000000100010000110110000000100000000000000001100000001101
00000011010101000000011011110000000000010010001000001010110001100110111110010000100100100011000001100
00000000000000100001000010000000001000000000100011000001011000110010110000000000011000000000001110100
00000010010000001100000000000000001101010000100000010000100101010010010101010100000011001100001100101
01001011100010100001111000010100100100001000000010100011010100110000001000000000011110101111000000100
00011010101101011100000000000001110000001101010100110000100000000000101000000000110000000000000000100
10010000010101100000011000110010000110000000010010000010001000000000101000001010010100000010001000100
10000001100011000000001001000000010011100000101000100100000101000100000000100100000001010100000000100
00000001000000000100000000001000000010111001100000000100010101100100100101000001000000010100101100101
01000000000011000000000010000001000000100010000100010010100000000100001010010000001000000101000011100
11010000010001010100011000010000000000000000100001110001110000110010000110000100100000100110110010000
10100000111000001101100100011010000000011000001010100100010001000000010000100000010000001001100001010
00000010000000000000100101000011101000000000010001010010001010100100011100100001000100000010001011010
10101001010111000000001010010000011010100000000000000000010001110000000000001010000010000001001011000
10000010001101001111001010000000010010010010100000101000010100010000100100000000101100000011100010011
10110001001010001000000110001000000101000100011000100001001011001000011011011101001010010010001011100
01000010000001100000010010000100000000000000010010100100010000100100011011000000000000110001001001010
00000000010110000110000100100000000010000000011000001100000000000010000010100000001111000010000011101
10100001000100010011000100001010101000000001000000100001110100010000100000000001000011001100111000011
11011100011000001000000010011000011010000000001000010011001001000000001010000100111000001100101010000
00010010000010000011010001000100000100100110011000000010100000010110000001010011001000011001111000101
00000000011000101100010010001100100010001110110011001000000100001010001000000000110000010000001000000
01010101000000100000100111001010100100100011010000010101010100010000001010010000100110110010000010100
10010100000000010000000000000000100000010000000000000110000100000100000000000010000000100100010010010
00000011001000000010100100100000000000000100100011000001110100000000001100001100110010100000100000000
01000001000000010011101000000000001001100000000100000000001100000100100100000100000000000001100001011
00000001010100000000101100011100001010011000001001001100000100000001100001000000010110000000110011001
01100001100010100100101000001010000010000010101100001011100100100000100000000110000000001011101000001
00000100000010100000101001000010100000100001000011001100100101100000000000011010000101110000000101000
11001001010010000101000000100010000001000101100000010100100110000100000000000000001000001000100000010
00111000000000100001000110101011110100011000100010011010100001000100010010001001111111100000101000000
01000010000010000000110100011010110100010000100010100110111010111011010000100010000000000011100000100
00010000001100000000100000100001000111000001001000010101000001000100010000000101110000011000110010001
00110111011001001000000110111001101001111000010100001010010110010000000010001011001000000000001000010
00000100001110001000000000111010000010110000000101000000010101000011100010010101001001101010011000111
00010100000000001010000000101000000100101010011000011001001010000100010000011010011101100000010000000
11110000101101101100101010000000101000010000000011000000100000001110110000101010000001101001010000000
00011100010010001010101001000111000000000010101000000100100000101001000010001000001001010000010001000
01100000000000101100000011000000000110100000010100000000001000000001110100010001010000000010101000100
00001001101111111000010100110111000100100010000110000010010100011100000000010100000101011010101100000
00100001100000000001000100001011010000000000000100000100001101001010110101011000000010001001001000000
00000110000000011000000001001001010000010001011010111000010100100100000100100100111010000010000000011
00000010000000110100001000000011000010000110110000011011000010011100010000010010000100100000101000110
