31 0
24 46
00110001100000010101010000100000010100101000101110101100010001000010000110111000101100000001010010000
11100000000000000000000000010110001010010100001000000010001000010010000100001101111000010001000100100
00001000100000011001111101110000100000000101010100000110100001100100010110110010010001000001000101000
01110100111100100001000000001010100000010000010000001100010000100000001010000000111001000100000000101
00101000100000100001010101110000010001001010100010010001010010100000000100000100000000001100000011001
01001000100000110000000011011001000001010001001001100011001100000110010010011000001001001010010000000
10001001100000101010001000011100001010001010000000100011001010001000110001001000001000101010000001110
01110000001010101000100000000100000101001110100010011000101100010101010010100001000010111101000010101
10001100000000001010001001100100000000100101101100000000000000000000010100110010000001000010000011001
00100000000100100011000000010100000010101011000100101000011000010101101000101000000000110000000100111
10010010100001100100000000001000000000101101000100010100001010100000000010001100011010000110000111100
11000110010000100000001011010100100001000001011110011000000100010001110000000011101000100110110100011
00000000010010000110000110100100101010000000000000011101011010000000001101000000100001011000000000010
01111111100000010001000100000000010000001100000100000001100010100100101000001100000000110000010100010
11010010000001110000100000011000000100111001001000110111001101010000010100000000000000100011000000001
11000101001100000001000000101000100110000001000100101100110101001000010000110100100000000100011101001
01000000110000011101111100000111001001010000010000000000111000000010000010000101001100100000100100101
01101110000001001001100011000000011000011010000010001011100011000000000100000001000011001010100100010
00000110000100100010111010000001000010000100010010100000101011000000001001100000010000001110000010000
00001110011000010010010010000001011001010000000000010000101110001001000000010000001111001110000010010
10000001010100000100000001000100010000000011011001010111101001000010000110001001100010001000011001110
10001001010001100100010001010110110001000111101010001000010110000000000000000100010000100000001000101
01000000101010100100001010011100100110000000011010010000100010101110000010100010000000000011100100000
10000010010011100101010000000000100010100001001001011000000000000001100001100001101000100101001101000
10000000000100000000001100100000000000011001110001111001101001000101010010000101011000011000101101001
11000000000001001000010101000001110000000000001011101101011111010000000001000100100000010101100101110
00000101100001000110110000000000011100001000100100000111000100000000010100001001000011000000100000000
10110000101010010000000001011001101000101000001011001011011000101010001100010000010011001000100000000
00000010100010000000100000100010000011000000100101000010000010101001100111000000000011001110001011101
01101011100011000001000000011011010001101101010011010000000001000000000100101100110001001010000000001
00110000101010000001001110000000011001000001000100010100011001000001101010000010100000000000100110000
00010000000100000010001100000000100010100110001011000100100010100000000101001000010000111000000010000
10000001100111000100010101000111100001000010000010000001010111110000010100100000011000000000000010000
00000101000001000000000000011000100001001001111011000000000000000110100000001100001010010101100100101
00100011100010101101010010010101100111010101110000100000100101000111000011001001001000110101100110001
10100000000010100101000000010001101000000000000000010100000001000000000001010010011000001111001010110
10001100101110010000100000010001000100110011001101001110101000010000100110000001001000000011000000000
10110011100000000000000011100101001010000000110000100000110101010001010101000000010000000000100011001
00001100100100011000010011110000110011010000110001010000010101010001001000100000011110010011010001010
00001010000001001010000100000111011100001100101000111010011100011000010010001001000100010000001101100
01000100100100101001010000100001100000101010011110000101001110000100101000011011000101001000000110000
01011000001101000001100000011000100100001010100110001000010010100010110101101110000001101001011000100
11000100000000000010000101110001000000001000000000000010001100000001010110000000000001000100110001100
01110011011011010000000110000010000000100010010101101001100010100001000001111101101000100000101000100
10100100101010001011000000000000000101000001100110000101010001000100000100001010000000000001011000000
00001111000100110001101000111100010100000000000100100110101110110000000000001001010001001000001000000
00000000100010000000010100100010000000010000111000110000100001001100000100000010001000000010010001000
00010100100000000000101000000000000000000000000011100111011100001111001010000000000000011001100000001
00010110100000100010000010110001000111010000010010101000101000010000000000010010000000000010000000000
01000000011110001001100110010010000001000010000000100000100000110010001000000000000010101001100100000
00000100100001000111010011100111100010000001101010000001101100000000010111000010010000000100110100000
00101001000000100000110000100000000101000100010000001000001010001000000001001000011100101101001000000
00000001000100010110011100000001010000101101001100110110111000000000010000010000010110100001000001110
11100000100110010100000000100000000001001000000010000100000001100000110101001011010000100000010000001
01100010001011000000000010000001100000010001101000101101000001100100101000000100000101010010000000000
00001000001000100001100100000110000000000011000000001000010000001011110001001001100100110100000000001
01010000010000010110010000000010000111100100100000110000000001000100001100011010001010000000001101000
10000010000001100000000010000101001001000000101011000001001000111010100000000011010101001101000100001
01010101000000100100110001010000010100000000110100001101001000110010010000011110010000010001100000010
10011110001010000010101000010001001100110000110000101001000011000100000001000111001110000001111110000
10011011001001001110010000101000001000011111110000101111100001000000001001001101100000000000001000110
01001010000110100000110110010000000101111001000010000100000000001010010100000000110000000000110001100
10100000010110000100110010000010000000000101000100000000100101011000101100011000101000100000000001110
00110010100101101110100000101100001010000010000000011001000000001000101010101000001100111100001010010
01000001001010000010101001111101111010011000000001000000001000010000101101010001100100000101010010000
11000011000001001001010100010000010100000001000011100000001011100010011000000010101000000010110000000
00001110001000000101101100000000011000000000000100011011000000001101001101001000000000000100010001101
00100001000000000000011001000110001100011010011010000100101101100110010000101001101000000010101000010
00001110001010000001100001000100100000101100111000001101001000100001010110100001000000000100110000000
00011001110010000000000010000101000010000000000011101000000000000000100010011010001000101000000110011
01000000110001100000000100011001010000101010010000100011011010000010100000111000100101101010000001001
01100001100100000001000011010000100111000000000000100000000010110000001110001001100010100001001000000
00110001101010000100010010001001010000110011000100101001000111000110010110000000100001011100000000011
10000000000011010000100001001101100001101001010000000100000100001111100010011000000110000110100000001
00101110111000011100000001000110000101100010100010101000011000000000111010010110000100100001000101100
11100000010000010100011001000001110000111011000001100010001000000111110001100000000110010010000000000
10000001100010001000000001000100011110100010000000010001110011000001010100010010100000000000010010010
00111111000000001010111000011000001000011000000011101100111000010000001011000101010010001001010000010
01001001001000001000001000110100000101001000001000001000100000110010001000011000010011001010000100100
00010100100010001001000011001001100000100000000000000001010000000000000000010000001001111000000101000
00001001000010000010010010000000100000000101000000110000000100000000110100000111000100000000010000101
01100000000001110000001010100111000010011000101000011000001010101010101101001000001000100000001101110
10100100111101000000000010100000100101010000000001011000101010011110000000000001011001010100001110001
00011000111000010000000001010110000000000000010001100100101010000000000000001010010000000010001010010
01100000000010010010000000101010000000000110011000001000010111100000011111100001101001000011010000100
01010100001000000001100000010001100100001000000011001011100000000001000000100101100100100011010010010
10000101110100011010000101000010100011010101101100000010000110000010001110000001000010010000001100000
10000000001100000010101000100101011010010111011001110110000001001011001000001100000100011001001011000
10000001000000001000000000001100001000001000100000010101010000100000111110000010000110101000101100100
00000001010100001010001110101010001010110101000111000101100000010000010111011000000111001010000001110
01101110010110000010011000100100010001110101001000000000000000000101000100110001000000110000101100010
00000110100100001000000100000000110011000001001000000001101100000001000001000101001011100100010111000
01110001000000001000000100000010100000000011011100000010010000000011100010001001000010000110000000001
00010110101101000011000001000100110010010000100010001010110000000000010100000010000110000000101000000
11100000101000010010100001000000000001000010010101101000010101000100011010010000000001100000010010010
10111000011110100010001001010000001010100001110100101010101001100100100000000100100100000001001000100
00000000000001101001000000001100101101001011101011000100111101010001000100000000000000000100000010010
10000001011011001000100010110000101010100110010000000010000010110000000000100111101001001000110000000
00000000001001000001111000001000000011001000010001001010100000001100010001000001000100001100000011011
11011000010000001001000010001000001001101010010001011000000100000100001010100101011000100100010010100
10001101000100001000001000000110000000100000000101101011010001000010101100010000110001011101100000000
