24 48
84 43
01100011001100000100000100100100000010100011010010000000000001001010000101000000111000010110011000000
00100000100111100000001001101010100000001100010110000010000010001010000001100010000101000001000000100
00000001000100100010010010100001000000000000101011000101000000100001000000100001011100101011101000101
00101100000101100010100000001000001001010110101111000001000001010100000100001110010100110100010001010
00000001000010001000111001000000001000000000010000001000101001000001000100000100000011111000000000000
10101000011000000110000001100100101000011010000011001000100100101001000001011100001110000000001010101
10000000000001011110010001000100001100100010000101010101100000000100100000100000000101000000010100011
00100001000000101001110110000010101110110011100100111010001000101010000100100001001000010000010010000
01000000010011001110000100100110110000100000000000001100001000010100000100101110001110001000000000000
10010101011000100000111011000010000010100000000010100000000101001000011111110101010110101001100001001
00000000010101000010000011010010010000011011000000000001000000010000000000000000001011000010001001100
01011000000010000100000100010000100100010100001011001010010000000000000011000001110000000000001000001
11011010000000000001000000100000000000010000010110000100100100001101000000010000010010000100100001100
00001101001000010000100000000001001000000000000101010000010001000111000110010010000110000000101010001
10011010100010000100010110000010001101001100010000000001100010000100110000010000001101001011010000001
00000010000000000111010111001010011010011101101000100000000001100000000101100110000000000000001010000
01011000100000100100010100010000100011000001000000000001010110110100001000100000001000000100000001100
00000010000000010010000000001010010010000000010101010001010000000000000000000000101001100010100010100
00010000101100101100101100100111000001000010100000101000011000011000000100000100000010000000000000011
00000000100110000010000010000100011000001001000011110010001110100000011000001101000000001010010001000
00110100010011100000000000100110001000101001011100000000101000100110001000100010011100000000001000000
10000000010011000101111100101000000100100000100000110010011010111100111001110000011000101000000001000
10000001011100100000011001100001101001100000000111100001100000101001100101000110011010101001000001010
00000010000100100100001100011001101001000010101010000000100000110011000101101000010011000110010010000
00110000000110000000110000010000000000000010010000000000000000000000000001001000100010001100100100000
11100110000100000000010110010111100100011100000000010000000000000100110000000100010011110001100010000
00001010111011001000000010000110100000100100111010100010000011000011001101010001000100010000000010010
10000100001000000000001010001000000100110010100010000100100100000000010010001001011001000000100100101
00000010000010100110000000000000000110010100010110000010000101110110010100000000000000010000110000010
00001011100100001110011110001010001010000001000101000100000000101000001100001000000000000011000100000
10101010011010001001010010110000000100111100001010100000101011010010100010010010011000000100101100001
00110100000100101110000100110000010100100010111001010100010100010011000110100100000001110000000000100
00001001000010001000100010010000000011110011100000010011000011010100000000101110110100110000000011011
00001011000111000000000000000100011100000000100001000010011011000100011000000001001101010101000011000
00110010100100000000010100100000110010001001100001000011001100010000010000100000100000001000010010101
00100100000000101100110011111000001000010011010100101000100000000000011010100100000000110101110000110
10010000000000000100001001000000011100110010000001000010000000100000010000000000000001010000000001000
01001000001000001000001001010010000010010001010000001100101100000100000000001001010101100011001001100
00000010110101000010010000010000110001000111010000001000000100001011100000001110001001000101111000000
00000110100011111100000000000010010100010000010000010010101100000001100000100100000100100000011101011
00010101100100000111100100001010101100001001000001011010100000000010000000000101000010000000000100010
00000000000001101000110000111001001010000001010010010110011100000100001001110000011001000010001010100
00001011010000000010000000001011000110000000001011010000000101100000001011000101010000001101001010010
00000110011010000110101000101001010000010001100011100100110010100000101000110000010010000011000011001
01001001000110000110000000010000010000010000000000001000000011000000101110000000010000000110110100010
10010101010001000110010000000000001000000001000100101000100010110110010101000011000000010011000101110
10101010000000000110110000010100010010000100000000100011000100010100000010100110000010000011101000000
10101000000010000001000010111000010101100000000000000000000000001100100010111010110001110100100000101
00101000000100000100000001100000010000111000100010000101000000100100010000100100111101101001010000001
00011000000100000000001010011000101001000011000000000010000101111010000000110001100000000110100000100
00010000000001011000101100100000110010110100100000000001001010001010100001001000000000001000000011100
00001001100010000010100000110000000001000000100110101000100110000000100011001110000010000100011000111
01011000010000000000001010001000100000111100000111001000010110011001010001001000101000101010011010100
01011110000100000100001010000000000000010011011000111000110001000011000100110011001000010000100001110
01100001001010100101001100101010010001010000000000000010000000010010100001110101000011001100100100000
01000000001100110000000011101000100111000000000001001101001000100001100001001010000011000001010001011
11000101011010110000000000010100011000000010011010001100000000010001110100100000110001000010000100010
10000000000000010001010000011000100000110100100000000000000100101001000001000100000010000010001000010
01000000010000110001000000000001000010100001000001010101100101010110100001001000000101010001101010010
10000011000001000101010100100000000001011100110011001001011000111011000110001100000100100110011000110
10011110001110000100000100011100001000100110100101000000000000001010010100001000000001000000000101001
00101000000100011100001100000100000010110011010101001001010001001011000000000000000000000000100100111
10000000000000001000000011000100010010001110001001001001000110100110100000000000001000001101000010000
10000010000000011010000010000000000100101001010001000000000100010000000001100111111101010110101100101
01000000010000001001001000010101001100100000000100000000101010000000001110010010100000000010010100000
01000010000000100001011010001111001010100100000001000000110101000001110000010000001010000000110001101
11000001000000100001110100001000000000000001000000100010011000000010111101000100010110100100000001101
00100110100110000110010011100000100000000100000001000001000100011110000100000000000000001100000100010
00100001001011010010101101000000010000000100010100010110000000000000110000000000011001000110001000000
10000000100000010100100001000000100100011001001001010100010100111000000011000000000000110010001000001
01000000000001001011001000011011011010000000000001100010001011000010000010000000000011000000000010000
00011100010011000010010000100001100001100000101100100000001000010010001101100000000110000010001001001
00001010010010000010110010000110110000110000001010100000000101100101011010110000011101010010000000111
10001110100000001101101010001010001000000000000001000000000001010010001110101000010111001000001000010
00010001010001000010010101111010000000101100001100100101100010101011011001010010000000100010100001010
00000000000010000010001100011110001000000000011001010001000000101000100000110001011000000000000000010
00110101001000110000110100100010101100010001000001100000001001010111001101100000100000011110001110100
00000000011000000000001000000110001000000010000010000110000100011010000100001010100001010101000011010
00000010011010000101100011110110100101000010001000000011000100000010000000000010000001100110010001001
00000111000000001110001000000011000100001011000100000000110000000101000000010100100001010000000100001
10011101000000000000010100101010000000001010100000001000001000001000000000100110000000101000101000000
01100000110001011001111001001000101010010110100001100001001001000001011100000110110011010000000001000
00001000000000010010001101100011000001000010110010110011011010001100010000000011101101101000110001010
00100000001100010010001010001000100010111001010001100110011000001000111011000100000000000001101001100
01000000000100011000000010010000011010101000101010010010000000011101000011100000000110011110010011000
00111101111001000010110100010101001101001000111110101010000001100011000000000000001001000000000000110
01010100010001010000101001000000011010100001000010000101001101110000001010110000100110010000000110100
00000000000101101000000000100000001000110100000010101100010000000101010000001000000010101011110000001
00001001100101000001010100100000001001101000000000010000001100000010000000001000001110000001001000100
00000010100000000100010100010011000010010110011010110001010010000010110100000000011001001111110010000
00101000100011000100000110000000100010010100010110000000011110000000000010010000000001100010110000000
00000001001000101100110010100100001011101000001011000100011000101100000110000010001000001000000010100
10100110011000100010101000000100000000000010000010010000000001000010011100000010000000010110001101100
00100010010000000000010000010010000000000101110010101110001000100010010100110011011111000100101010111
10100010010100000110100101111001100010010001010111000001001001000010001010011100000010100000100000010
00011001010001110000110001100100000010010100000100010001101100000000000000001001101110100001001001010
11000010101100000000000100110000100000001000101001001100010000001001100100000000001100110000000000011
00100000000001001000010101010011000001100100000000010000011000010111000110001010001110001100110000000
00000111001111000001000100111000000001100000000010011001000000010101001100100000000010101010000010101
00100011100100011011010100000010100011000000010010010000010000101010000101000100010100000010100011000
10001000100000101000000010101001010000100110010001000010100000010101101000010000100101000000000101101
