72 13
48 26
01000000000011000101000010101110110000001001010010101001111111000001011010100010101001001000000000001
10110010011010010110001110011011010000000000010001100100000001100000000100000110001000101110100010101
10000110000110001000000100100101010001001010000101001000000011000010010000001011100000010100000000010
00000001000000100000000000000001000101000010001100001100000100000010100000110010010001101000010010100
00001011000000000100110000000110101000000010100000110100001001101001000000111010000001001111100010000
00110000010010110010001000000001001000000000000010001000011000000110010110100000000011000000001000111
00100001100000010001010000000000011001000001010000000100000001010000000100110000000000000010111011110
11010000000000010010100000000110000101101010000000100110011001101010001001100100001000011100000000001
10101101101001000001010000100001110000001100000000001100100000010001100000000000001000111010100110001
00010011000010000000000000001101000001010000001010010010000000011100010001111001100111000000000001000
00011100110110101111011010111101001110110111000110100100001001011101000111000000000000100000000111010
00101000000101010101000011000110000000100000101000000011010000100000000001001000100010100001000000001
00010001000100110001001000000000000000101000010110011000101001000010101000110010000000110110000111100
00000100110000100101010000000000000011001101000000100101001110100000011000010011100011000000000000010
00101101000100001100000001001000100000000000100110001010000001000010000101000101000100110001101001001
00100100100100000111000001000001000001110000001100001001000001101011000000011001000001000010010001011
00011000100000001010101011000000000101000101101011010001010000000010111000101000100101000000101010000
01100010001001010101010100001011100110001001010000100010001010011011110000001000101100000001010011100
00010001000010001101101001010000001011010000100011100010000011100100000010000010010010100000010000000
00000010000000000101000000011000010000000100100000011010010011011000000000100010010100000000010000100
00000011001000100001001000101110000001100010000010011000100000000000000011100111100000010000000101110
01100101101000000000000100010101000001000101010000000001100000100110100000001000100010100000101010011
01111110000111001110000100011000010000010010110100000100000100100101010000100010100101100100100000110
00010001001000000000000001101010100000100000000001010001011001001000010010010001001000010001101101000
00100001000010010110110101000100100100010010000101101100001000000101000010100001000101011111010000010
00011011100000101100000000000001000110000100001100010101000010110000011010000000101010100101000000010
11100000000010000010000001101000000000100000100010100100110001101001000000100001011000011100100001000
10010000010000010001110101001000000000100111000000001000010110101100000000000110001100110000000100000
01001011100000110010000000100010111010000011011101000010010000000000100010000000000100001000000111000
11100000011011001000000000000001000000010011010000110001101100000000100000100110000100011010010101110
00100010100100000001110000000000010000010001011000011010000111001000000010000110000010000010000100001
00011100000010011000100011000011001010011000000001000100101000111000000010000000010000000000011010100
00010100110110100000000011100001000100111000000101010000011010100001010000000000100111000110000101000
10000001001010011010011010010001001010000010100001010101110010000100100000001000000101000010000001111
01100000110001011000110100010000000110010100010001001110100001000101011000000110000000100000000001001
01000011101010100000100000000110001111000100110110011000111110001011100001000000000100011001111000000
10010000011001000001101100000000001000001010010001010001100100010000000011100101101100101000000001111
00000101100000110000000001010100100011010101011010010000000001100000100110010000011000011001100100010
00000000111001010000000000000000001001011010000010011000001101000100001001001110000010010000110000100
00010100000100111010101000010010101000101100111110000100000000000100110010000100010011010101001000000
00010100100100100100000000011111010000000100000010001101001000000000110110000000011011110010001000100
10001000110001000000100000100001011101000110000100001101011011010101010000010100000000000000001100001
00101010000001000001000100100010100100000000000110000100000010010001100011000000110000010010000001000
11001000000010111001001110000100010111000101000100011100100101000110001101000001010000001001010000100
00100001100110000011000010100101011000100101110011000000100000000001000000010000000000000010000010000
00011010000010000001100010011000000111010000011000111000000011000010000100001100111000000000100001001
00101010111100000000000000000000000000101000001101010000010010000010000000000110101000010110001110010
01000000110000010101000000001000100010001000001100110110100001000000100011000000010001111000010100011
10000000000010100010000010000001010000111011101010010011100100000001110000110000011010000000001100000
10000001100010000010101111100010000101100110010101000010001000000010000110100111000011000011100001010
01000010111110011101000101010101000000010001110010000001110000000000100100001010000000000000000001010
01010000001100000011001000000100100000110000100010011110000010001111000101000001001001000001010000011
00000001000101000010000100100010001000110010000000000001000000001010010001111100100100001001000101000
01001111000010100000010001100000100110101010000011010110000010011100100110010101000010001000100000010
00010111001010010001100001111100101000100100000000110000111001000111100100010000100000100000011010110
00000000001100000000000000001001010100011100000000000010000010010001001000000001000000010100010100010
00000000011010010100010000000001101101111100100001010100100001001000010001001100110000010001001000010
00101000000110000000100011001000100100100001100000100001010001000010110010000000001111010001100101000
01101101001010001001100000101000000010101000100011110001000000000000100011010010000110100101000000100
00100001000000101100011110100000011000101100101000000001110100011010001100001100000010100100100000000
00000001000000100001010101010010011000000000110101100011000000101000000000100100000001010001000000000
00111100011001101100100111010000101010000000001011101101001010010011010100001101111000000001001101010
10110000011000010111000000000101011011000000001010001010100110001100101000111100001100001110101011000
10010010000000101010000001000011000000000110100000001000000000010000110000010100111010101000000111000
00011100001000000100000001101010010100010001000100010001100100001000010100001100001110000101000000010
00000100001110011100100101101100010000110010000110001000000110101001100010000100001001000000100100101
01011000010110000000000000001010010111100100100100100101100100000000101001111011100000000010001111010
11001000001000000111001010100100001000100000001000000001000010000010000001000011110000101011000010000
00010100010001000001000100100010100000011110000010000101101011100010011110000100000011000100100001000
00101100100101000000111000000110001101000010100000001000001101000011000000000001111110111011000000110
00000000101001110101100010101000001100100100011001001000010010011011000000000100010000000010100010001
10001010000000010000001010000011101011000010100101000011000100001000000011100101000001010100000010000
00000100000100110000010101000010001110001000010010101100100101000100010011001000000000000000010000000
10000000101001100011001100011001000011000010000001010100000101010010001001010001000010101100001101000
01000100001000001000100000100011001010011001000000011000000010010010010001011010011000000110000000101
00101101001000011000111000101100001001001000100010000010010011011000110000101010011101001110010000000
01000010010000000000000001001010000110000011100000000010001110110010000010100000000000100000100110000
10000000010000010000100000100011001000000100101000000010010110000010000001110000001101101000101100000
01110100100000000001000101100010000100111110010110000110100000001000111100001000001110100000101000111
00110000011100100000000110110101001000101000010000110100000000111000110000100010100001001000000111100
00000001100011100100010100101010100100100000000000110101010001000111000001000000110010001000000001010
00110000000101000100001000001100100000000000110001000001110000100001010000000010110001000000001010001
00000001011110000001101001010100100000110010001000011000110010000000010100000011011000111000100010111
01000000011000000100000100001001100010111000000001000000010010001000100001100100010101100100000100010
01011001111001000100000000100110111110000101000100000000000101001101001000110001010000011000010101000
00101011100000010011001000001000001000001000001010011000100000110000100000000100000101011000000100000
10011010110001110011000100011001001000110101000001000010010000000001000000010101011010101100101100100
01000001100000000000000001000100001101010001010111000010100001010010110100001000010001000010001000100
01000000000000001100000000000001111000000100000000111101000000010000000001001100100000001000001010010
00100000011100000000000001001001101111000100000110001001000000000100000001011100110100010110100000101
00000010001001000000110101100000100000101011100101010000000000010101000000010110000011100000011001000
00000000000111000000000000000000000100010101001101100010111110000000100010001000100010000100101000100
00111011010011110000000000010000001000001001110000001101010000000100100000001101100000110001110101100
00000001000010000010111000000010100000000000011000001000110101001010000000001111000000000000001001011
10010010101000010010000001000000011011101000000000000011100001000011100000010000101011101100000101000
00001111100001001101000100110100000010000001001011111000000000000010011000010000000011000011010001001
01000000000000001000101001001001100010001000100010000110000000000110001000000000101100010001000000110
10000000000110010100000101010000011000100000000100001100000001010100001010100000000001000000000000000
10011001111101000000010000100000000000000000000100011000000011001100000000000100100101101000000100010
01001000100000001100010110010000010000011101100000000111010000011010001001000000010000011001000000101
01001100110011010100000001100001101000010000001000000000110110000000001011011011101100000110011010000
