0 75
87 4
00000000010101011010010001100000010000101111100110010001011010110000000100000000110000010011000000100
10000010010100100111010000011000010011000000101001010001100100010010001000000100001110011000001111010
01101000000000000000111011000000100101001101100110000010010001000110100000001001010000011010000000010
00000100100000100011000000011100100000000100001101000100100101010011110000000001001001100111011001000
00000001000000010000000000100110000010001010001001001011000000001110000010000001001010010101010110000
00001001011000000011001000000000001110011000001000000010100000101011000000001000010110000000100000000
10100000011000000000101110101010101100001010010000101101010110100100011011001000010000010001000100100
00010010010000000000001000010010100110001101001000001010001000000000011000001000000000000011101101000
10010101100000001010101000011001110000110001000100001000110000010001000000010000101111110000001101111
10100010000010010000100111101001000000101100100100010100000000101010000001100100000000110000000000000
10101000011000000010100010101011000100110000010011100100110111001000000000010000000100001000001100101
10001011000000000011100000010100000100010000001001000000100000001000110000000010010011001000001001000
00010000000000010110000111100100010001001010000011000000001000000001010000000011000100000010110101000
00010001100000010011110110000000100010010001010110101101011110000011110000101100110100110100100000000
10101100001100010010000001011101000110100000000000110011010100000000010000100000000011101000001000100
01000011100100000000111100000110000011000010100011001000000101000100010011101000000110010010000010001
00010000001000111000010000100101100100011100100000101001000010010000000000000110100101000001111100001
00000110000011011000001000100110000000010010100000001000011010000000100101001010000100011000000110110
00000000110100001000000110001001000101100110000000001000000101100010010000100010101100111100000010110
10000000100000101100100001000001010001001000001010000000000010100001100011000110000001000001110010000
00000010100001010001001010000110010010110010000010010011010000110100001010110000100100010000000100011
10001010010100000001000010010010010000000100000001000001101010001100010101000001010001100000000001000
00100010010010010111010100011101010111111011001000000000110001001000000000010010010000100001010000000
00010010111111010110101100010110010010110000100110000000000000001011101001100101100101010001000010000
01101010100000001000000100001001110000000001001000011100011000000000011011000010100101010010110100001
01010000001001110000000001000000110001000110000000000100100001001000110100001000100110100000010101100
00100001000001010100000001000000101100000000000001011000001000010000001100000000000100000001010010001
00000000011000110000011011000001100100100111000100010100010001011101000100000011000110100000101011000
10001000110000001010100100000100110000000100100001100000000101001000011010110000000111000010110010101
10010100000000100000011010001001110000011001001000110010011000000000100011100110010000001010001000000
10000100010001100101001000111000001000100000011011001001000010000101001101000000000000000000010000011
01100001101111000010000010000000000101110000100101000001100001000000010011000011100010000000100010000
10100101000000000010010100000001010000001010011011000000001000110000010000100001110010010000001001101
01000100000000011000000110010001010011011001000011001001000000000100000011001000000000101000000010100
00101011000101011001010010100001010001001000000010000010001010010100100100000101010101000001000001000
01100100100100001000010010000011100011001100000011000000010100100000001010011000101001001100000001001
10010101000011010101000000001010101000000000100100000000010010001001001010011000000001000000000000101
01010100100110011010101110100101001000000110010000010010001011001011001000000000011100110011010011010
00000001000000001000100000010000001001100000000000000111110000000001001110000000000001000100100001010
00000111001100010000000010010001101000101011000110110000010010000000001100001000000100010001000010000
00000000000000100001000100101001001000000000000000000010010000000110010001010100000000110001010011000
01101000010100001000000010001000110010000100101001100101010000000010000110101010000011101100101100010
00010000011010000101000011100100001011000001000000001000101100000001000000010000100001000100000010000
00100000010001010000001010101100001000100100000101000000010110000001000100010011100000010001100011010
10000011010000001011100001110100010010001110000000000000100111000100000010000000001101000010000000110
00001000010000001000101010011100001011100010100010010001011001000000000010100100001011001001000011101
00100000000100000000100010001010001000000110011100011001010000000110001010000001000100110110110000000
00010011011000001000001111000011110010000011100000000000100011000001011110000101000100001101111000100
00010111111101010100000100000000010100101001100000101100001010000100000000000000010000100001001000100
00100100000011100000001010000110000100110000001000000000000000000100000000101000101101000000101010100
00111000100010000010010001100100100010000000000010000000000110001100100001110000010011000000011011100
10100101010001010001000011010011011100101100100001001101110000001011110101000000010010011000001000001
00000000011001000100000111000000111000010000100001000010010001010000010001000110110100011100010010000
01000001010100001001111100001000100111000101001100100000000000000000100001000011100000000101100111100
10000100100010100000001100000110000010111000000000101001001000010010000110010010100100001100000101010
00011010000010000001110000000000100010000001001000100001001000001000100010101001010011101000001011000
00000110010000000101011010011000110001100000011010000100000011001000110010110000000001000001000000001
11110001001100010100010010001010010000000001100100100000100000110000000000000001000100001000001000000
10000011110000010000001000100001000101000100010010011001100000010001100110000000100000100111100010000
01011000000100000100101001000000100000000100001100000010100100000011100001000000100010010100100000011
00110110000000000000010100111000001010000001100000001010010001101000001010010100010000100000110010001
00000010100000000000101100111000001101100010000010110000100100100000000100000001000101111011000010010
01101010100001000000111000100000011000010000100110100010000101000000000000000010001000001110000000101
00010001011001100100101000010100000011101100001000001000100000000000100100001001100001101000000000000
10100000100111000000000010000000000000010000100000000000001011100000000010010000001010000100100000001
00000100001000000001010000000000000100001000101000000000100011000100100111101101000100101010100111100
00000100101110001000001110100000000000001000100001100110100010010001010100100100100000000010000000001
01001000000000100010000000001111000000000101100010010111110100001100000100100000000000000000100000000
00000000001010101110100011110100101000001000000000001000010001100010001001011000101001000000000000000
11000110000001000000100001100000010101000000110000001111001000100011000100100011000101001100010000000
00000000000100101000010000000100001100010000010001000000000010101010100000100000101111100100010001001
00011100010100011111000000000000000001000001011100000000001100001000000000001000010000000000100100011
00000000100100100010010010001101011010001000100100110100010100111000010010100000101111001010000100100
00001011010011010000001000000010000001000100010001010001000000000000010000000001000101100101111000100
00011110010100100001010100001011011000010101100010011010101001000010111001010100100010011010111001010
00000000001000100000010001011000000010010100000000001001010000000000000001001100010111110010100011100
10101000000010000010011110100000000100000010000001001001000000100000000010110100000100010000100000001
10100010110000111000000001100100001010010001001001011000110001000000000010000011000000000001111100110
00100011100010100100101000010000000110101010010100110111001100000001101110001010010000100000001000010
01000011000101000000110110111110010000100000001101010100000010000101100100000000001000100000000010100
10000100010001010101011000000111100010000001000000010000001100001000000100010000001111001010100011010
00110011100000010100000000001000000100101101010010010111110001100000101000000110000010000001100110011
00100101000001101100010000001100000100100000100000000000010010101101001011101000000011100000000001000
01001010101000010111000010100101010000001000001010010100000001000000101001000100100000010000011000011
01000011010000000101010101100001010010010001001000000100000000000000100100001110010001000000001000010
00011001000010000000000100010001000001000100011010000000000000000000101110001000010001000110000110000
01001101001100000000100100011000110100011000000010010101000110110000100001010001010000101000000101010
10000001010000111111010000001000000000101110001001000110010011000111001110000101100000110100000100001
01011110000100010100110101100000010101010101100100110001100000000000011011010010110011101000000010001
00100010011101000000000100000000101010100000000100000001000000001100101110001001001011100100010010010
00001101001011100000000000000000010000001000001001000010010000010011000100010000101100100000100000001
10100000100010000010000000100100001000100000001000000010110010000010101101001100000100001000100000000
00100000000000000101010011000000100010000001000001101010010001000010000110000000001010110000100010101
00101000010100000000101010010011001011101000010000100101000000110000110000010011000011000000000001100
10001110110011001010100000000000111011000010001100001010101010010110001011100111010010101000001000001
01010001001000110101110000001010000100100001001000000000101100100010110011001001011000010111010011001
01010100100000000000010000001100001101110011000110001000001001100010000101000010110000100101001000010
00100001000111000000100001000100010011001010010001100000011101110001000111000010000000001111111001000
10000001000011000000110010000010000100011011001010100000100010011100000100000000010101000000000000100
01000001110010001101001100100000000010010011000101101000000000001001010000101101000000000000000001000
00001100001000001010001100100001000010000011001001010000100100001110001001000110001001010100000010001
