59 75
2 76
00010001010010010000110000001100110000101000000000101000011101110010011001100000000100000010100010010
00000000011001100001001000010000011000101010000100110001000000010000101000100010101001010000110010000
10000000110001110001100000011101000000111001010000001000000100101101000000010000011000001000000010000
10000111000110010000101000010000010000010000110100100100000010001000100000000100011000000000000001000
00100010000001001100000010101000100111010010110000000000000100010100000000000000101001000000001100001
10010010000000110001110110110000101000100000000000000001000000001000000000100001110101000110011100000
01001100100000101001001111011100010000011110001000101000001101000000000100101000001101111011100000000
00001000110010000100000001100100010000111010101000000100010010010010100000100001000011001101011000000
00011100100000000000000010010000000000000100001111100000010000000100000100010000001011000001100000011
11010000000100000000101000101010100000000110001100001000100000000101000001110000100100010001001000100
00110010110001000100000111001000100000000000000010001000010110001000000000001001000001000101110000100
00010100100000010000100001000000000000000001000001110010001010011000001001100000001101000001010100101
10100001000000000111100100000001110110011001100001011001001101000100110010000000101100000100000000100
01101010001101000011011011011100101001011011110110000010001000010000000110001101010011101000111101011
11101000001001000101000100001101000001000000000001001001001000000101110110000000100101101110011010111
00100010100100000001000001100100101000010001000000011101011101000010010001100010101011100100000101100
00000001011101000011110011000100100000011110000000100100100001011100100000100100000100000011101010000
00001010001011100010110001100000100111001001010001000101111101000000000101000010000010100000010000100
00001010001000010101000000101100100100000100100010001001000100010011001010101100011100000100000110000
00000000000011100110010000101011000000000010011011000101001001010000100011010010110000000101000110111
01001000010000101000100101001000011101000010000001100000000001011001000000101101100110001000011101001
00000000000000011011000110100001100111001100100010001001000000101010000001001001000001001100000001011
00000010010000010010000001000100001000000111100100001000001000100010100100100010000000100000100110000
00110000010010010001100100011111000110000000000011100000000000110011001100010000100000100100000000000
11000100011001101000010100100010101100011111011000000000000010001000010010000010000010100000110101101
10000011000111001001001100100000110000101100001000100011010001010010001110000000100000001101011000010
00110000000000000000001100000000000010110000001010010000110000101000011000101000000001000000001001010
00010101000001101101000010001101110000101010000110010110110100010001100011000100001101000000100110010
00100001010010101100000010110000100011001000000011000000010000010000001010010010100010000010010010010
00001101010010010000110110000010000100000011000100100000001000010001000001000101001010111010001000110
00001000000001000101110000010000000011100000001000010010001100100110010011111100100000101100000001100
00101101111001100111000101000110011000010011010100000100110011001010001000110100000000100100101011001
00000000001100000000001011110010101000001100000000011000111001000000100010000010000000010001010100000
00011000110100100001000100001101011000000101110000110100100000010010000010110100000000000011100000001
01100000100100001111001011110010000101001000000010110101010011000000100110000000000000001000100000000
01001000101000010011000100110001101001000000010000101000101100010111100100100100000001001011011010110
10000010000000000010000000001101000000100010000010011000110110000011000011111100010000001011100001101
10100010100000001010000000000001100000000001000001100100001001001100000000010100000000000000100000100
10010111011000010101011010011111101110001000011000001100110010000000100000110000000000100010100000011
10000001001000000001010000100000000000000010110010000000000000001000111000001100000100000011100100100
10001010100000000000010101011011000000011100010001000000001100101100000110000100010111000000010110010
10010001111101100000001100110000110000000010100000000000001001000000010010011110000001110100011000001
01000101011100010000101000101000001100100000110000000100100011001100101001101001000110010110000000100
11000000000100001000100010000000001001010101000000000100000100010010100011101000000100000010011001100
01001000000100000010100010000000000000101000000000001101010100010011000100000000001010001000001000111
00001001001010110111000010010000000010100010000100001010010110100001001000010001001111010100001000010
00010010011101000001110111010000110000010000100001010100001000011100010001010000001000001011111000001
01000000000010110100000000100010011110001000011000101101000011011000000000000101100000100000000101110
00000000001000101001000110010000110000000001100000100001000000001000010011001000000100000000000100100
00000100110000000100010000010000000010000001000000111110011011010000010100001010011000000101101000001
11010011101001001101000010010100000001100100110010001110011000100001100010011100010000010011010001010
00000000010010101011000000000110010011010000100110100000001011000011010011010000100000000110001010010
01010100010100001000000000100100010010000110111110000001000001010110000000110101100001011010000000000
00100010000100000011111001010000000000101001100000010100001010000101110100001011000100001000011011000
10001001101000000011001001011011000000000010100010010100100100111000001001000011000000100001000110000
00000000001000000100000010010001000000010010110100000000000000010000010000101001001110100000100011001
01000000110100100100101100000000001000001001101001100011100101100000000110100100010001100101000001010
00111000000000000011001011111000100010001010010010001000100111111001001000000001000001111000100000000
00000000110000000010011000000010001000001010100010000010100000001010010001001100110110000110110001000
00000001000100100000010110000000000000110100010100101101100110000010001101000110010100000011010000100
00011100001001000000000101000100000010100000010001000000100000000101110001011010000000100110011000010
10010001000000011000010001000100000010001101000000100001000010010010000111000010000000100110001010100
01000000110000000100011010001011001000010000111000001000101000001000100000111001010100000110011011000
11101100000011010000010001000001110000111000110000001000010100000000110000010101000010011000001010000
00001011010010010010000010100101001000000000101000100101100110100001100100010011011000010111101000000
10001100000011010000100011001000000110000001100110000010000010100110111000010010001000000101000011010
01001010010000000110011100001110111001110001001010011011010100001001010010100110010011101000100000000
00110011000000010000001010010101010110110000001000001100101111000000100000011001000110100001000000010
01000100010110000101100001000001001100010000010000101110010010011010000000000100000011010101000000011
00000000001101010010000001100110000100101010000110010010000001000010011001110010001001011000101000001
00000111000000100010010011000000000000000101001000000010010010010001000000010000110101001000000000010
00000001001000000010100000001011100000010100000100001000000101011000001001000000101100100010010000010
00001100000100010000010110110010010100010000100010001100100000000111001001000000010000100011000000000
00001000100101000000111000011011001000010111100100001000001100000100101000101110000100010011100101001
00001000000100000011000110000011000101100100100000000100001000001001100111010100011010000110000000000
00100001101100000001100010001001000001001000100000000010010001000000010000110010010000100001000000000
00110010100100001000000001001000000010100000101010111101100010011100101001011110000010001010001000100
10010110010101111000010000001100111001111000101110110000111100100100001001100000100011000000000010000
00010000010010000001000100000000000010010101110011001111000000101010001110000000100001000000010000000
00001001000100001110001100000010010001000110000001010000001001010010000000001110001010011000000101100
00000000001010111001101101011000100100010000011000011000101010010001100001000101100010001001011010000
10010111011001001001100000010000010010110011000110000011011000100110010000010100010001100011001000001
00001100100000010100001001001001000100001001110000011001001000000001100010000011101100100000010000100
10000110010000000000100100100000110001000000111100000110111000011101100100100001010000001001010110001
10001001000010010100000110000010100011110001000000101101111100000001011000100000100001101001100100101
01000100100000000010110010010100100000000110101010000010000111010101001101100010000100000001000010100
11001101110010100101010000010110011000100000000010101000110001010011000000011010000100011100010000000
01000000000010100100001010101000001001101011010000000000000001000000001100000101100001011000000000100
10000100000000001100010100000000111010001000000100000110101000000010011101000010101100001010110110100
10000001000000101101100110111000101101000110001011001010001000000011000000010000100100100010010101010
01010000010001000001000011000010000101001001110101010101100001000000000001100110100011001000110100011
00000001100010000100001000000000000000010110001100100000010111100000101000001101000000001010000100000
10001000000000101001001000110010100100100000000100000001101000000011100100000011100001000000000000000
01110000001100100000000000010000100110010001110000000010000111000000110110011000011001010000100010001
00010000011000000110001000100100000100000101010000100001100011110100000101100000100011000000100010000
11001100110000000001100100011000100001010000010000100000000010101000001000001001000000000000001111000
10100111000000011100000001010010010000101101001100000001010001010010110001100000000000001001101001000
00100010100100110000100000000000000101000110100000100110111000001100110000100011011100100111110000001
00001000011000010001001100111000011001101101100011010000001001000010100010001000000101100010000010000
10000000000010001110100000000001000000110010001001000100010001101000000000010100110001100101010011001
10000001000010100100000000010001101100000000110110000100000010100000000000000111100000010000000010010
