71 97
2 82
10100011000000001011010000000110010000001001000000000100100000100000010011000000000110000000100101010
01000010000000000001000000000000001010100001100010100111101000000001000100000000011100000100010010000
00101100011011110100000001100010000010010110010000000000000000000000000000110000110000001011000000001
10001101000000001001000001000101110001001010110110101001000100000001011000010000000101100000011111010
01000110010011011110011001000000000101010100001101000110100101100101000000000011110000101010100001110
01001001001000000000000000010000000000000100010111100010100100100010000000000100100100000001000001101
00000101110001100010101011010110010001111101101000110010010000011001011000000001000110000010010000100
00101000011100000000000001000101100000100000000001000011101000100110000001000010100001001001101011011
00010101100011000100111010001110000010010000110000000100000100100100000001011000101010011000000100011
10010011000000100100001010000001000110001100011100011010110010000010101110000110000000001000000110000
11100000000000001001101000110100110000000100000010010101001000001000100000000000000000010010111010000
01000100010000010000101100000010000100000100001001010000110010001100000100000100000001001010100010110
00001010101010100000000000100010010001001010000001111000100001110000110010000100110000000100101110000
01000000100001000000000001000001100010100000110001100101000110000000101000101000010001000010010000000
00100111000000111001000000100001100111100010001001100000000010000100000000010101010001101000000010000
00000000000110100000001111010010101100110101000100001110100000000000010010000100010100101001100010111
00010110001010000001000000000001100001010110000100001000101011001100000010000000000100101011000100001
10011011011000000000100010110010010100001011000101010010000010000000001000010000011001100000000000000
10000010100010001101001001001000000000000000101010000101000101000000010001101101000100000000001011010
00011001000010100000000010100100100001000010100000001100001000000001010100000010010010001000000100000
11000101110010100001011000001010101000000011000000001100000000100000100000000000001000000001000011011
00100001010000110000111100001011011000110101110010100001100001010110001000010101010101000100000100000
01001100001100010000000101100000100001001010100010010101100010000000100100010010010110001010100000000
10000010000001010000100010001000110100101100001000100110000000000101000101110000011100000110001000110
01100100001010100001000000000010011011000000010000000000001011000101100101000011000010000000110100101
01001011000000100001000001000000010101000000010001000001010100001100100010000000101001000010000000100
00101000001000000000111101000000001100000000000001101001111000110001100000100100110010010000100001100
01000001000000010000000011001101010001010110000101001001100100100000011100001011100000010000001010010
00001110101000011100010000000000010010010100101010111001000010010001110001000000100100001000110000000
01110000101010010000010001000000000110110000011001000010011000100000010110001000000000011010000100111
00101000000100100001100000000001010000111011000100110000000000001010001000000000100101000000001101111
00001100000001000000101100011101101000001000011000111000011100000010000001001100000110000001000100000
00100000011000000000101100100110001001000000000010001000000001010111000011001110001000000000100100000
00101000110100011101100011000000000001000111110000101001100010100001000010000011011000111010010000010
00011010000000100100001000000000000001100010100010000001000000010100110010001000010111101000000001010
01000100011001010001000001000000011001000000010110100010100000000000000100110000100000100110000010011
00000001000001100100000010000011000010010110010100100010011010111000101000110010100100011000000000000
10000000101000000100010110110110000000001001000001110000011110000011011010001011001010000010000000010
11101000010100000001000000001100011000000000010000000001100100100011011010110110100101111001001000000
01000000000000100111000001110111000010000111000011001110000100101100000010010001100101000000000001010
01001010011000010000001001001001000000010000100100100001110100000010110110110100001000001000001000000
00010000000001010000000001011001000000100011000011100110010010100100001001100011100010010100001011000
00000010110010001100110100101011010110010010010000101010010000000100000101000001100100011100100000010
10100001010100001000000101011000000000010100100010001101000100000100101000000011100010000100110011001
00010000010111000001100000000100100000000010000000010110000000100000000001001100001010011000000110010
01000000000010101001010100000000000001000001010011101000000001000111101101010010100000000100001000100
10000110101110000101100100001001001000110000010001010110001000000001001111001100101100000000100010010
01000001100010000001101000011000001101100000001110000000100100000100000011000001011000010001000100101
10000001010000110011001000000000011010000101010100010000100110000111001001011010000000000011011100110
01000001000001011000110010000000101101001100000100000100000000001110100001000101100000100000000000000
00011100001010000111000100100001001110100000000000000000000001001001110001001010000001000000000000010
10000011000000000011000010100000100000000000000101001001011100001001000000001000010010101010000011001
01001000100111000010001100010110011000000000010110010001101000101000100000001000000100100000000000101
10011000000100010000000001100001110000000000000001000010010100010000000001110100100000100000000110001
00100100000000101010100000011000000010010011110010000000000010101110100000010010001101000011000101000
00000001110101100101001101000000001010010000000001100000101011101010000000111010100010111010010000101
10001111000010000001011000000000011010000110000001001100001010010010000100001010000000101000011000000
01000101000000000101011010100100100010000000000000010000010000000010101010000000100000000010101101000
01101111100100100100100010011000010001010100101110100011000100010010001100000000001000110000100000011
00010000000000101010010010000101110011001011100101011000101010101001000010001010011000000010100010000
10000001000011000100101000010011010010000110001000000100000110010000010001100100001010010011001100001
00010010001000011000100011101000100000100010000110000000100000100010101000100000000000001010001110100
00010000100110101010101000110010111000101101100000000110001111011010100001001110000010001000001011000
00001011100010100011000000100010100000110001100001000011010001100110101000000101000010001000111011101
00111001000011010010110010011001100100110000100001010010000000001010000101001010100000000100001010000
00100100000011001100100010100010001101001001001100000001010000010000000100010000000001000000000000001
11001100000010010000001011100001010000010000001011000100101110001010000010010000001111010000101000000
01110001010001000101110110010100100000010010110100100001000000100001100001101011011001111001001101001
00101000010010100000001001011000000001000100011101110110010000010100010000011010000010000000000000000
00110100010000000100010001100000001010010001100101000110100000001000011010000101001000000010000011100
00000000100100000100000000000001000101000000111011000100001101000000001000010000010101000100010000000
00000100000001100000000000100001000000000000101001000000010100010011100001101000000011000100000000001
01000100001001000101101000000100000011000100101010010110000000000000101100000000101000100010100000001
00000000010000010010010010100000000000010010000100010100001001010011010000001111010001000000100000010
00111111100001010000001000000000010001100010001000100010001010110000100100101010010000000011000110000
00101100000010100100010110000000000000100100010100000001110100000010011001001000000110001001101001000
00001011100010101010111010011010111100010100010001001001010010100011100000000100100000111010110100001
10100100001000000001100001000010110000000010100100101000000010010100111011001000000000011100011100000
10000000111001000110000000011000000000100100000110100100000000000000011000001010000110010010000101000
10101000010010000011000001101000001001101011001000000001000100000000011001000001100000011100011000000
01001110011110000010000000001010100001100110000010000000000010000000000100000010000001000010010100101
10001000001001110001100000000010101100000100100100000011000001100010100010100000000001010000001001100
00000000100000010000000000100010001000100000110101000000101000101100010000000100000011010010101001000
00101110000010110001010000010010010011010010000111001010100001010010100000111000001001000010001001001
10000000100100010100000000110010100010000110100010000010000000000000100001001000100010100000010101000
01000010000010000000010000000000100010000000000100010100101000000010110100000000000110010110000110001
00000100100010101000000101000011000001000011010001011001100010101110000110001010010100101000100000110
00000010000001110000000010010010011001110011000000011000010010010100100100001100100000011100000000001
00010001101000010010000000000000111010100011010100000000001000101000100110001111000101000001110000010
10100100001100000000110011101101000011100001010011010001100000000100010110000001110000100110000000101
01010101110001100110000001000110000100000111011001110001000000000010011000000100100000000010000011000
00001111001100000010010000001100000111100100010001100101100010010011110010100001000001000000110010000
00100000001000000000010101001110111000000100001101000110110010101110010000100010100100000100110011000
01100010010100111001110001001011100001010001010100001010010001000001101110110000001100001010100001001
00010110000100010000101000000100100000000001010000010110100100110100010000101111010011011001000100001
00000101001000011000010110000100101100100001000001000000100000001000000110000000000000001010000100000
01000010001101000010000000010100110100101010011010010101100000101001001001000010100101101000110100000
10010000100111010001000000000101000000100010001101001001000100000000001000010011010100000000010001010
01101010100000010110000110101000001100000100011010011100000100101000010101011000101100000111000001001
00000110000110101000000110010110001000000000001100000000000000100001100000010100000000000110110000100
10101010010001101010000000011100000001010010100101010100100001000110010000000000000001010010001000000
