57 68
92 95
10011110010100100010100100000100010000100000010110010001000010101000000100000000010001011100000100001
00100010010001000000001000000000000000100001000110010101011100000001000000000000000001100010000000100
00101011000001000101111101001110010010111011001110110111010100000000001100010000001110000010011000000
00001000001111010000100100100111000000100100000000100010010111000100001110011000101000110000100001000
00000010000100100110100000000000110000100101000000000100100000100001000001001100000100110110101000000
00010000000000011100111010000000010001000000100100000000000011101000001010100110010000000100001000100
01001101001000000011001001101000100000010110100000000111100100000000001101000101010100010100000101001
00000010101000001110010000111101100000100000000011001000011111010000011110000011011000000000011011000
01100000011001000010010101000000000110000010100000000000100000000101100011101001010001110111000101011
01000001000011011100010100000111000000010000000001000101000000010000000000110000010000010001000011101
00100000010100101001001000001010010100100000000101101010001000101011100010000000100001001100010100100
00000001000010011110100111100000000100000000001010000000101001010000100000100000001000100010010000100
10101000010100000001010101010010000000110000000011010100010101110101000100001000001110100001101000010
00000011101000110000000101010001110110001010101011010010000110001010101000100010000001000001101111100
00110001001101000000010010000100010010010000010100001000001010000100001101010000010011000000010010101
01001110101111001001000000100110010001000011010100000100101011010001010010010110000010100010000001010
10101100010000000001001011010100011001000100010000000011010000000101001110010001100100001001001001010
10000011000101000100000101001001111000000000001000101100110000000000111110000000001100010000000100011
00010000001000000000000000000100101000000001101000010101100011000000000000000101001001100001011011100
00010000000000000100010001001000000010001001000000001000000110001000000000000000000100011000100010011
10010000110100100001000011011001000010001000100001100101000000000010100000000000000100100011001001010
01000000000001010010101101101101100001100100111000010010010010110110001010000101110000011110010000000
10010100010010001001100010010101001000100100101110010000111010000010100001000001100000101010001001000
00010001110111010011000101110000001000100000000000110000000100110000011010110100000110001000100010000
11001010100000100001100001010000000000110010010010000000010100100101100101000001000000010010000100110
10000001001000110100010110110111101100011001000000000100000010000110010101001111000100010100110111001
00100000000001010000010001000101010011000001000101111100110100111010000000010000000000000001001000010
01000000001000000010010110001000001010100010100011100010011001000000011000110101001000000000010001010
10001000011010000001010001001011000000100000000000100000110101110001100011000100001010000010000101110
10101001000101101100001100101000000000101000100100000010100110011101100000100011000110100101101010000
01001000111101000100010100000010100000100101010000000100101000000010011110011110110110010001000001010
00100011001010000000111000010000110000001000011001011010010000010000001100000001010010000000000110100
00000001100011000001000100100111001001100110001100000000000100100000000010010000000001000100000100010
00010110100000000001000101101001010010000010000000000000000000000000100101000010011000010010011000000
00111100000100000000100001000011100000000000010100010100010010111100110000101110000000100000001000101
00001010100000110010101100001000001000100001100110010000011000011000010110000000000000101011000000000
00010010000110000000010111100011101001010000000000001000010001110000010011000110001101100100000000000
10010000111100101000001000000011010100000000000010110000010011000111111000100000110010010011100000101
10101010000000000001101001111110000010010001000110000000100000100010000110010100000011110111000110001
01100000000001011000000010000000000000000000000100000000000000011000001000000000000000110000010001011
01000001010011000011110010011000101000001001000001001000001100001010000000001000000010010000000100100
10000001011000000001100000000101000010001000001010100000000000001100001000001000000000101000001010000
00001001000010001000001000000000101010010000010100000100101100100000100111010100010001011000000010000
00001101100010100110010001101100110001011010100011010011100001000000000101000000001001100110001011000
01100010100101001001000011000100110010011000001000110000000101000010000000111000100100111010000000000
10000110000011010100011000110110101000001101000010001001001000001100010000000100000001000100010100110
00010101000000010011100000000111110000110000100000100010110010100000110000010001001000111001000000000
00000000000000101101100000010000010110100001100000110000011000010100101000011000000001000011000010011
00000000010100001100100000100010001000000101000100100000000000000011100001010010100000110000000110101
00000010010100000010010000101000010000010010100100000000000100000010100010001001100000000100100000000
00010011001001100100001011111010000110010010100001110000000000000011000001100011010000000000001100100
10110010101100001000100000011001010000000010110011000100000000000000010110100101010000101100011000000
00001000110010000100101010010001010000100011001000011011001010010100000001001000110100001100001100101
01011111000010001001000000100000101000000000000010100000000100110000010000000011100111110101101000001
01100100100100100000000010111000100000000010000100100000001001000000000001010110100010100000000000011
10100000000010100001000011100001000000110000000101010001000001011111000001000011000000100001010100000
00000010110000110010011010010100011010001110000000010010110000010000011000011110100100000010100100010
00000111000000000000100101001000011010001000001001010000001100000000001001010010010000101001000001100
00010100001010001000000000101100001101001011001100100100000110000100101001000001100110000000100100100
00101011100001001011101001100000000110010000110100110100011010010000100011010011000100000000100000010
10010000010101000101010000000101000100000000101000000100000100000000001011000001000101100010010001100
00000000000011000010000001000110101100110000110001001001100000000110110000100100010010101010101101000
10110100000000011100100010100010000000001010010011000100001000000010000000010000110111000110100100000
00000011000001000000011000100000101100010111001001000000010000011100010100001100000000001000111101011
11001101000000000000000000110011010100100100100010000100000010001010010001001000001011010100110101011
00000010010000101000111010000000000100000100111001100110000100110100001001100000000100111001001010110
10001111111100100000001000010101110001000000010000001001100110000011100000100110001010100000000100100
00000100000011001100100101000001000100010101000100000000000010001000000000000000111010110000001010000
11000101100100100000000000101100100100000100000000000000010100000000010000011000100000000001100110000
00000001100000100010000000000101100000000000101000100000001000001010000000000111101010001000000001000
10100001011000001011000000010100001010000011000110101001010011001100011100001100000100101000000100010
01011110001000000100100110100001011010101001011010110001001000100001010100000100100000100001001000000
00000001000110001011001010110001001011000100000000010100110000010010111000100010000011101010110100000
01100000001000010001000011000101000000100100001000100000010001010101001010001000100101001100110010000
01110000010100000000000000011000000011001001000001010010110010000011010010000001010000000101000100001
00000100000100010100001010001000001000011000100010000011010010000000000101001111101000100000101100000
01000100000000010100100000010100010100011001101010011000110001000100110110001000001011000000000100110
11001010010010000000110011100001001000111011010001100010100000010010100101000000010010000000110011000
01010110001010010001001001100001001011000000011000110100010000101011001010110001000101111100100101000
00111100010010100000000010000000000101000111000010100000001001000001001101001100101010000100000010010
00000000100110110111000000110000100000010000100010001000000010000011010000000011011010011000100100000
10101010000100000000001010000000111110000010100010010000100110100010110100000001000001111110000110001
10000011100100000101010100110000001101000011011100000101010000001000010001011011000100000000101100100
00110000000010001000010111001010000011000010101100000101100101000000010000110001000100110000110110010
11000000011111001000011010010000100001001100010000001110010000010001000110001101000001001010011000100
00101010100000010011001000010010101100100000101000000000010010010100110000100000100100010011000111010
00011000010001010000000010100000010001001001110010000011000001000000101100110100110001010000000010101
00001111000001000000100000000000011100010001011000000101000010110000000000101001001100010000000001000
00000100010000011100001000110000001101001000100001100000010000010010011001100000010110001110010000010
01000001010010111100011010001001000001000011000001000000010100000101100000001000000101001010000000000
01001010100000000010100000000100100000000111000100000110011000000011000010001110001100000100010000000
00000010000010000010000100000100110000110100010000101110111000100100100111001101000000000010000011100
00101000001000000000000100011000000000100011000001010010100000000010000001000001100000001100000001100
01001110000010101010100000101001100010000110000010110101010000000001001101001000001100000001001000001
00100100001111011100001110000000101010100010001101001110010010101001100000100000010000001000010000101
01100010100001100100000000100000001000011010000001100010100100001011010001110011010010000000101010001
00000100111010010101000000111100001100010100010101111011010000110000001100000000110001110111000100000
01101000010101001100000000110000110001011000100001010001000000111000000000010110000001000100000000000
00110000101000000010000010010100010011001000110100001010000100100000000100100101010001001100101000000
01001001011001100010000100000100011010000101000010001000000110010101000100010100000010101000010000010
10000000001000000001010100110000000010000001000110000010110100101000000000000001001000001100000000100
