28 88
54 96
01110000000100010001000000001100000001001000000000010010101000001000000110001101000000000000101100100
10000000110000101000010111100000100000100110000001000000001001010100001101010100000010000001010010000
11000001011100000010000011010000001110111100101001001110100010100101000000000101010000010100101100100
00000100001001111000110001000010001100100010100000000001101000100010001000101000000001001100010010001
01010010000110010100000001100000000000011011000011100000000010000000011110000000100001000011000010011
11100000000000110000010000011000000001001000000100001010010001011001000101000000100100000001100100100
00001000001000100000000100110001010101000010110000100001100101000000000010010000100101000000000000010
00110000000111001001111000000000111000001000001100000000010110000000000000000010000001011110000000100
00000101010010000001100000000001000000100001000010000101000000000101101100000010100000100100001000000
01000001100010000000110100110000100101000011001000000000000110101000000100001100100000000011000001000
10001100000100000100110111110000001001011111011101001001010000101000110110100010010000011001001010000
00000011011000000100101001001011000000000000010001000000100000000001100010100000000011100000000110000
11011000000110011000100001010100000000010000000010110101001101001100111110000000100010010001000001100
00100000101110100010010101110000101011101010010010100000100000000001001010000000010111001010010101010
00110100010000010000010001100000001100000000001001000100000101011000000111011110110001001000010001000
00100001001001000010010001000111100000010001000101110111000000001100000100000001000010001100000100100
01000001110000000000001010001010110011000101011000100010000000000101001111110100110000101101000100110
10000110000110001100101100100000001000101100000000000001100000000000101000000000000100001000001000110
00001001000000001011011001000000011100110001010110010100000000110000110010100110011010010100011011100
10101110011100101000101010011000000001001100100001010000011001100001000000010010001100001011100010001
01010000010100010000000010000111011011000000001000110001111001000110001000001110011010000101000101010
00000010010101000000011100100001001010000100000010000001001000000001001100100001000000000100000000001
10000000010100010000001010010000001110010010000000010000110000100010001000000001100101100010100000000
00100010100001000000100010000000010000000001100000000010010110000110010001000100000000100000001001101
01000000010010000000010000010100011010100000010101000100101001000100110000010010010100001001100000000
00111101010010000101000001010101100000000100110000110000001001101010000010001000001010101101000000011
01101000100010001010001100000000010100011000010000000000010000000100100000000110000011010100000100001
01000100010001111010001001000000011010110000000001000010101000110001100110000111000000000000111110100
00100000100111011000010110000000100001101010000001000000000100110101000000100000110100000101001001110
00010000111001110011011000101000000011010000000000110011001011100010110000010000001010000000100110001
11001101000100000000101110111000100011111001010001010000000000010001100001100010001001010110100010010
10110000100010010000000001001100000000100010000001110001001101110100001100010001010000000011000000001
00000000001010101100000010001000101111011001000000000010110100101100001100000000001111100100000100100
00100000100100010001001000000001000010100000010000001100100010000000110001010000010101001001000110000
10011110000110100011100001000010011000001010000100010101000100100010100000001000110001011100001101011
00100100100001001010001000000011000110000011001011000001000001000000001010100100011001000001001001001
10111000100000001001100001000101000110000000010000000000000011000000111010011000001011000010000010100
11000000000111001000101101100101000001011101000101000001101010000110011010010110001100000100000001010
00011100100100000010000101101001010011100000000001000111000000011101000000001000100001011000010000011
00000100010010000110001001100001101000100010000100000000100000101010010000001000011000000001100110000
01011100010000001000001010010101000010000001101100001010010001000001001011001110010000100100001001100
00001100101000000000110000001001000010011110000000000000010001001010000000010000011000010100000010101
10000000101100000100000010010001000010010000000100100001001000100110001010010101010000101011110100000
00101001010100001010011100100000010100101001010001000001000010000000010001001000101100001110011010010
11000000000000001000000001110111110000001011100010000001000000000000001001110001110101000000100000100
10100111000011000001101000010000001011001110011010010100001000100110000001010001000010001100000001010
10010010000000110000000000010000010110000001001000100001000001000001000100100000010101000101010000010
01000001001011101010011000100000011001100001001110000011000101010101011001101010101000001000101100000
00001011010000100000101111000111100001000101001000000100110001010000110000000000000100000001000100110
10011000001000101011000000001001000010010010000101000000011000000000000001110000001010100010110110110
01101010000010000000000000000001000000001000001101101000001100001101110100101000000010000000001000000
10000001101000101100100110001010010100000010011000100001000000110101011000000010001111001100010001001
01000000110110100110000010000000100101011101001000000001001011000100000010000010010100000000110001000
00100000010100000000010100001001100000000110000001000100100000001000000010101101000001000000011110100
01100000010011001010111000110010000000001011010000000001011010000100000000110010010000000000100001010
11110010000001010100000001100010000001111000111010100010010100100100110010001000000101101010000001001
00010000000110000000001110101000000100001000000010101001101010001001100100000011000110100000001000000
00100001110000011000001000101101010010010010101000010000010100000000101010011011100101000000110000010
11000110011000001110001000010000001001001001000110100000000111000000000000101010001100001000010010010
10111000001101001000001001010000000000100000100110010000010100001110001010100110000100001101100010001
01111001011101000110001011110000001111101000010001110000000000000000011011000001001000110001000000100
01000000010010000101000100000110000100100011001000000010000000101111000010000000010010100100101001000
01100110100001100001100101001010000101000001101100001100100000010101001100000000000010101000100010000
01101110000000010010000010110100110011000100011001000000101010001100000101000110000001110000000000000
00000010011110100000101000111010000110001010010000101001000000000010000100010000011110001010000000100
11000100001001100101001000001011010000010110100001001000000000100000010100010100000100010010100101000
01010010100110000000011000001101001000000010001001001101100001000000100001100000110100000000011001000
00100000000010010010000000000110010100001010010000000000110000100100100110010100000001000000000000110
01000111000000001011011001000110001010001001010100000000001110011010011000010101000101000000100001000
00011000000000000100100001110100001000110000001001001100111101011000001110111001010001000111000010100
00100010010000000000111011000010010010000010000000010110000011010110000010000110000011101001000000010
11000000010100010100101001100001000100000001010111110000000100001101010111100100010110010000011001000
10000000010011000001000001000011000011000000100010110100001000101010101000100111000001001000000110101
10101000000000000000011010100000010000100000001100000110000000100011001100110010001001100100010101101
00100000001111000000000011001000101010000001001000001010000010000010001010000010000010100010110000110
01101000001000110001100000010100000000000000010001000110001101000101001001100000001000010100000100000
00011010001001100000010000001100000000000010000100000010101010010001011010000010001000100100100001010
10001001001000001001100101100100001101000000000000100100100110000100010101001000110000000000001010010
00000000100000010000101010001000010010010000010010011100000000001000101000010001011100000000011000000
00010010101100001110000001010010000000011010010000000010001010000100001001000000100001001100010100000
00000100000100001101000101010000000100100010010110010010110100001101010010010100000000000001010001110
01110001010101000010011000010010000001010000110101000010101001010000110010000000000011000000000111100
10010000010000100010001001011000000011000000011010001001000000110010000000010000111000000001011000000
00000000000000101000010001000011010100000110000001011001110100011000000010001000000101100000110100000
10000100000000000010000000110001000000000000001000000010000000101100001000100010001100110001100000000
00001010000100100101000000001001110000100010000100011100000000010001000010000000001010010100000010011
00011010000010001011010100001100101110000010000010000000110000010001001000001000100000000000000111000
00000010000011001000000010001010010111011100000010001010100001000000010101000000011010000111100001100
00100110000100000001001000000100000101001000000000010000000000000111000010000001000001000100001000000
10000100000001010000000110000101100001100101011110000100101010010001001000000100000000011000100110001
00000010001111000100100010000101010000000011010001000011010001000000000100001100000010111010100001000
00110010110000110011010110000001010001000000001010000100000011001100000000100100101001000100000110101
00000001001000001100010101000010000001000010000100010010000100001010000011001000100101010011001101100
01000000000100100011000000000000100000001100000001110100100100010011000010100000100000100011100000101
00000000000101000000010000000001010100010000000100000100100100010100001001001000011010100000000010001
10100100011000000110000001100011010000100001100000010100001101100010100100001000011000000000100000000
00001010001111000100000001001100000001001000110010000001100101000000011000000000000000001010000100100
01101101000100000000010101000000000010101000010000011000010111000000001000011110100001101000011000000
00100111001011000010101010100000011000100000000000100000000100100010000000101001011010000011100101010
00100110101100100010101010000000000100100001100000000000001001010000100000000010001100001010001010010
10100000010001000011010000001000001000010000010000100000101110010000000010110000001000110001000100011
