17 57
88 71
00001000000001001101001100000101001000001000010101000000011100110000010010100101011110010000001001001
00010011000000000010001000010011000001010110111000001110010001000100000001101000000011000001010000010
00010001110100111101100000001000101100101000101000100100100100000101100101000100100000000011000110011
00101110100000000000000100010000000001010100101000001000000000110011000000011000000000001100000000000
01100011001010000100110001001001100000001000000001000100101100000010001100100000100000000111001000000
10000010000000001000110000011100000100010100011110011000000000000000101011000010000101100100010100001
00010001000111010000100000010010000000000010001101000001000110001000000101011101100001000000000000010
00010000110000000000000000011010011000000101001000001100010000010100101010010000100001000000010010001
00100001000001000010000101111010101011000010010000000000000101010000100001000001010001001010101000100
00111000001001001100101000001000010000010000001000000100010011010100100000100000000000000110000000000
00101011110010101100100000001100010100000001000101000001010000100100000001011110000100100101000000000
01010100000011010001000101001101010001001000001110001100000000000000000100111001000000110000010100001
00101010011000001100101100101000000001100001001000010000100000100011011000000001000000001100010011111
00100101001000010000000000000011110001001000101101010001000000110101001010000010101010110001000000000
10000010000001011010100000011010011110000000010010010000010000010100000100100001100010000010010000010
00110010110010000000110000111000100000110001011101011111000010100100110000010001010100000010101110000
11000110000010000011100000000000100100100000000000010101001011110010000010000111101011100001001101000
00001000000000110000100001010100000000110010100011000100001100000100110100100000000001000111000000000
01101100001000000000100000000000100000000100111101000011001010010110100000110111110001101100000001000
01000000000001100000000001101001001100010000000000101000000100100001001100000100011000000011001100001
10001000000010101000101100101001100101100101000000000000000110110010001000001001000010000100100010100
01010001001000000100010000001100000100010000010000010100100000000100000101010000001000000000000110000
01111010000010110011000000000100001010011001000001010000000110010101100101001000010100010110000000001
10000000000101000000000001000000000000010100000010010111010000000010110100101011010110110010000011000
00101100000110000100001000110001000101000000000000001100001100000000110101100110100000110011001000010
10100011100001100100110000001000111010000000111100101000100001001000100100000001100000110101010010110
00100111101000000001001001100101000000001000011001000000001100001100100000100000110000110010100101000
10001100001010001010000000110010000100001011010100110000000000001000101000100000001101100100000001011
00010000100001101001001101001000011001111000000000011001010010001010000100100000101001000000000100010
00100100001001000100100000110111010110001000010000100000110000010000001100100010010000001000110110001
00001011000010001001000000001000010000000101100100001010000000001010010000100000100010000000010100100
00101001000001110000000000110111001100000010100000000100000000101111100000010000001011001010000000000
11000101101000010000001011001010001001100001001010011000011100010100100000100001000000011010011101010
00110100101010101100000111000010101011001010100100100010110000000110000000000010011000011100010100000
11010001100100110000100000000000010011000000000000100111000010011010100010101010010001110001100000010
01000000000010000010000100100000000000000010010000000001000101110101100000010000100100100001000101000
01110000000010001100000000000010000000000000010000010000000011001000100100001001000000001000100100101
01001010000101001011000000000001011100100000011011010000010011000000011001000101001010001000110000100
00001010010000010000010000001000000001000001000011001000000010101010010110000011000110011011000000010
00100100110000100101001000010001000000000100110000001100100000001010011000001000001010100010000110000
01101010000000010010000000000110000011000000010000100110000001010100000010000100000010110000000011000
10001000010000000010000100101000010101101010000000001000010001111011110000000000000000001001001010000
00101010100001000000000000101000011000100101100000011000000101000110001001001110000110011001001101100
00010110000000000000001100000101011000000010010000011001000101010010010010110010000000011001001100100
01100101010000000000111000000010100111000001110000001000001100010011001100000010001000000000100100110
01010011001001100000100000011000000010101000010110100100101000100010000000001000000111000000110000000
00000000110001000100010011101101001011001111100000101000100000000100101110110000100010111110000000001
00100000010100001000101000000000000110101010000001000011001000010001010000010000010000101010001000100
00000000000100000001001011001000000100011100001010001111100000101010000000000100011100001100110000010
00000001101000100001011011100001001000100000001000000100000100000000010010000000001001100000000000000
00010010100011000011101000011101001011000110100000000110100100010101111000001000010001000011010110010
11001000100000000000001110010010011001100000111000101101000111001011000100011000011101010011011010000
01000010101010000111110100000000100000010011100000000010010001000010110101000000000000010101010000100
10010000010101010000000101100100010000000010000001000000000100000010010010101101110101000100010101111
00011011110000101000000100011000000000011011000010000001000110000100101100010000000000000010001001010
00000001100111100101001100000000010000010001110000000010010100010100011100000000000000010100000100000
10010010100001011100000011000011001010100111001000010001000011001000100110110011000100001000100110010
01111001111001100100000000001001000011000101100000011000110001001100000010000011110011011000001000001
00100011010001000111111000000001110110000100000000000001010001010100010001100000100000000001010011101
01010101000000000100000100010001100110110001001000010100000000000010101000000000010011011100000000010
10101001110000001010100010000000010000110110001010000100110010001000000010100010000100100110000111110
01000001100010000000100001000000111100001101000011010010000101100100010010000000111101001010101100100
00001101000000101100111000000010000110000011100000100001000000010000001100001101011000001001100000010
01011100010001000001010110001000100001000100100000000101010001000000001111010010100001000110000010010
10100001000100000010010000110000100011010010010001000001010100001001110001011100000100000001000100000
10000101000011000000110011001000000000000010010101110000100010000000000101000000101000000100000000011
00010100000010111000010010100100000000000100000110001001000011000001000001000100000111100001000000000
00001011010001010100000011000000000011011000101101010010000000010011100010000001100010100101011001000
00001000100000110010101011100001100001000111001010010001111010010000000010000101000100011000000000100
01000000000010000010011100000000111000000100001010011001000010011001000000001011000000001000000010000
01001100011110011010010001110000100000000000000000001001000000100000010011010110011101001000100101000
00100000000000000011001101000100000010100000011101101100101000110100000010100001000100100001001100000
00000010000000000111000100011000000000010000001000000000011001000100000010001000101000001100010100010
11100011100001001100010011000111000001110000110100010000101010000000010100000000101010000101000010001
00001000000000000000110011001000001001000010000100100100000000010101000000100000000010000010000110010
01010000011000010010000100111001000000100010000010001010010000010001110001011100101101011000010000100
00110001001100001001011010000000001100000000000001000010011001010000000000100110010000010000001111010
00000001000010101010000001011000000010100110001011001110100000010110101101010000000000010000000100010
10001010000100100110100000000010111001000101000101100011100001100000011100100000011000001001000001000
00001000000100001111000100100001010000000000011000111001010001100000000011001001000000010010011010101
01001100011110100000000111000000100110010010001100010100100100000100111010100001110000010101000110100
00100100000000000000000001100001001010010011011000010000100100010010100000100000100010010100110010000
00000000000001010110100100101001000110000000000000000000000100001000010001000000101010011100010110000
01000010010010100000001000010010000000000000011110011001000010010010010000000100000000010000111010100
00000110000010000000000101100000000100000101100011011000010101000110000100000001101110010000000000100
10000100001101111111000100011000000000000010001000001111000011101001000010001000001000011000010000100
00000101011000010010100110011001100000100011000000000100000110010110010001000000000010010100000001000
10000010110000001110100110101001000111000100110001000000111000011000000011001100110000001000000010000
00100010011000011101001001000011100001011100000010001100000000000100000010101000001101000100000010001
10100100010100000010001000010000000001010110000110111001011010100100010101010010101000010100000001100
10110011100000000010100010001011101000100000000000010101010011000001011010000101010100000010010111000
00001010000100000100000100000101000100010000001000010010001000100010010000010010001001000000000001110
00011001001000000110000000011010010010100110010100011101010010010101010010101011100010000000100110000
00011100100110100110010100000100000000010000011010000100110000000000010000101000010000010001000000100
11100000010101000000000010100000000000110000011100000010100001110100000101000111100100101000001100110
00000110011000000000000010010101010001001101110000101001000100010001001100100000100000100011010101011
00000000100011000001001000000000110001000110100000110011000001011010100000000100101111101010001100000
11100010011100000010100010000111000010011111000111100000000000110100101011101000000101100100011000010
01000011010101101010101001101010111101010000101100001100111011100000000010000110011010101110100000110
10110011001001000000001100100100001000010010000010001100100010000101000000101001010001010010001000000
00010110110001011000100000100011011001000000010011001000101001001100101100010000100011000000000000100
