4 100
26 90
01010010000001010110010110000000010100111010001100000001001001000101010100001000000001000000100001001
00100010011000010010000110100010010011000000000110100001000001001000010111000011101100000000010011001
00110000000000001110000001000000001001100001010001011111000000111001010110010000000000010111011000000
01010000110100000100011100000001000110010011010101101000001100111101010000100000000100010110010101001
00011001100010001001000001001111000011101101100100001000000001000000110110000100010011000111101001110
10010000010100000000010010100000010000001010101001001000100011110001000010111000100100111001010000000
00100000000001000000000000100110110010110001000100000010001000000100000011000010000001101110001111000
00010100010000001001011110000011000000101010001100000101000010111001000000110101100100100011001100000
01000100010001000100010010011101100100101001100101010011001100001011100000000010000100001001000001111
00000011000000011000000000110100001001101000001110100000001100101000000000100100010101000001000000110
01000000000010000101100101111101010000011101000000100011000000001011100001000000000000100011000000101
00010001101001101001000001000000000000000100101000101001100001001110010000000001001100001011001010000
01000100000000100110100001100100100001001101000010000010000000111010010100000000000001010101000001000
11000101011100110001001100001100100011001000010000000101101011001000011101001111010100000000000111001
10000000100010010011101110001110011100110000000000000101000000000000000001101011000000000010010000001
10010100000111001000000010010011001000000100000000101000100000000000011000010001010000011100011010010
00110101110000110010001000100111001101100000001010100001000010010000111000010100010001000000010001000
00100000000001010001011010100100100000110100000001010110000010100000001010100000100100000110100100000
00000000001010100100110001100000100110001000000101100100001010110010101110001001000000000010001010010
10010000000010100000000010000101101000000000011000101100000000000000100001000000000000000001001010010
00000000010000100000000000000000100101100011000010010010001000000010110011000000011001000101100001010
01000010000000001000001110010011100000000000100000000100000001011001100100100000100000011000001000100
01100001011000000000000010100000100010010101000100001000000000011000010000101000110000000000000000010
01011001010000000000000001010101010110000000000000000000010110011110000010101001001000010101100111000
00000000000001001000000110000000101110010000000010001010000000000110010000010001100001100000000000000
01001010000111011010100100000000000001101001010010001000110000001000001000100000000000000100001000001
11100010000001001001100000110000110000000000000010100000001001000001101100000000001000100000001001000
00000100110000011110001011010000001100100100001000010101000111101010001100010000001000000010100001101
01000101100001010110111110110001011100010000010100011000100010001101111000010010000001101001111000001
10011010000100000000000010100000000111000000000000000000010010101001111000101000000100000000000000000
00000011010000010000000000001101110100100000101011100001010001001001000000010000000001010000100001010
00000000000011000100010000000000101010010000010100001000000011100000000000110100000100110010001011100
00110000000000001000010111100010001000101010000100000000010000010100010001000000010000010000010000000
01100001101110000000001011000110100000111010110000000001101000001000000000001000101001001010001011100
10000000100010000000100101010001101000000111000000000010001000100101011100000000000010001101011000000
11110000000010000100100001000000000110010001000000000010101000000000000000010110001101000000000000100
00000000000010010001000100011011000011101011000000000110001000100000100000000101110100001000000101100
00000101000000000010010100000100001000010011000010010011000001010101100000010110110000010101010000110
10000010001000010000001001100001001000111010011010010000001101000110100000000001011001101000000000000
10010000000000000000000011001100001001100111000000001000101010110110010001000000010010011010110100000
01000100101000000010101000100100001000100000011010010001110000001110010101000111000000110001010001001
00100011011110010000100001011000001010110000001110000000010001000000100011000000100000100001100100101
00010001010010001000000000000000100110100111000010100000000101000010101000101111000000111001101010010
01101010100011000100011010101100100001010000000000011010000100001011000110010001110010000000000000000
10000100010100100010000001100000000010001011000100000000011100111000001010000011100000101101010010101
10000000000100101100101000100110001011100101000000010111010000001011000000011110001101010101000000000
11000100111010110001000011011000111001001010000111000000100011000000000000000101100010110001010100010
01000001011000010110000010101100100000101101011100100001100011001101010011101010111100110000110000000
11010000011000000000001000000101101010001100100010000001010001111010011110001111000000101110011001010
00000010001010010001010100010001000001010011110000100000101011000001000101011001000010011000010101011
01100000000101001110000000010011110011011000000100010000010010000000000010100010001101010010000000010
11100111100010001010101000010000110001001100101100000101011010001000100010011001100110001001001001101
00000000101100010001000000000000010010101000100011001001010001000010010100000001000000000000000010001
00000000000010000110101000000000000101100000000100010000100000100100010110000001101000000000000000101
01001010000000011001100001000010001100010111000000000010001100101101100011010010001110000101010001000
10001001111010111000000000011010010100100000000100001000010010000000001101010010001110000000100111010
00010001000000101010001000011000101100001010000000100000000101000010010001010101101011000010000001011
00010010000000010100011000000100100011110001101010001100000001100101111011000010001010000000001100000
00110011010000000001001110000000110001001001010000000000011101010000100001100000011000000001100100000
00010001101001000010000000011010000010001000001010100001101001011110001100001100100010000001010011010
00001000000010100001101011100000001001010000011001000100000110100010101010000100011000000010111100010
01100101111000000000000001010001001000100000010000011100100000001000000001000100011001001100000000010
11000010100000110000001111000001000011100000000010101100001000111100010010110110110000001000100010110
01000001110000100010000001011100101001000010001000100001000000000001111001001110000000100010000001010
00011000010100010010100100100000000011010000000100000000010011000011000001001000000101000100110101010
00000100111000000001001000000001010110110101100110010101000000100000010110101110010000001010010000011
11010000001001001101110100011010100001000010010101001001010000010100100010101001100000000010101110101
01011000000000100110100000110100001000100000000100011000100001110000101001001000110000100000001000001
10110100100110101001001100100100010001000010000100110001001000000000110001110001000110010110011000010
10001000010110001011110010101000110000101001100100101011010000010000001000011010000110010000000100010
01000010000001000000010110011000010010001100010000000000000000000000010000000000101010101000001000000
10100000100000000011000110000000011000000010110110101001100100101100101000111111100000100000011101011
01010010010000000001000000100001000100011000101100001101010000000000000110101000010011101000100000100
10001110101110101000010100001001000000000000000010001100000000100000000100100000001110001001000100010
11000000000000000001000011100000001001000010100001110100010110110100010100100101000010000000000100001
00000010010001000100010100000110001111001001001000010000000101010100101010001000101100010011010101000
00000000001001110000101101110001010100010110000000000000001000110000100101001001011100000101010011101
10000000000000010010101101100110101000000000101010000110001101000011000010000000000001100001000100010
01000111000001111000001000100000000100011100000100000001101010110000000100010001110100000000100000100
10000000000000001101111010010100111000110001010010000000011000000000100000100001000001100100000100010
01100010101010001001000000011011101010001110000000100001000110001000000100000001000010010010000000000
00011000000110100000000101110000000100000000100000001000000110000000001000101001000101000111001110000
01000001000100000001100101000001110100000100110000000101000010000000100100100010000111000000100000001
01100011000110010011110010111010100010010000000000100011001111010100100100010000000000111000110101110
10000001110010001000001011000010001000010010000010100010001000100000100100101100010010100011100101110
01110110101001010000000010100000001101100000010100000001000000110000001011010101000000110000000110001
01010010001000000000110100000000001000010010001101110000010000000000011010100011000101100010010001010
00010100000100000000100100001011100100100010010001100001011010000011000110000011100100101001111010001
00001000110010101000100000000000001011000001000100010001000011000000100010000000011000001010101101101
00110000001000000000110100001011010001001111110100010100011000100111010000011000010010101001100011000
01000011110110000000000001010001101100110010001010000000011000010000110011010111000110101001001100001
11010000100001111001100010000001001100010011010000000000100101000000000011010000000000100010000001011
00000110000001110110000001001001000110101000000011000110001000001101011000100001000000000101011000000
00111011001000000010000000000000000110001001100010001000000000100010000100000000000000110101111110001
11000000001010000000101001001100100001010100001000000001000000000100110011001000010111100000100100001
11101000100000001000000100100000000000100100110100010010000000011001000001000010001010000000001101011
00100100001100010000000000100110010000000000000100000000100000010010110010001000001000010100111000100
00100000001000001101000101101000000000101000000000010010010101011100111011110100111100000010100001100
01111111100110001100010100000001000000100100100110100000001000100110000000010100100110000010000100010
00010001101011000001010000000000100000000011000000010010101000110100000000101000000000011010010100111
00001100000101000110010000111101010010101011000001000010110010000000011000000011000101110010010000000
