18 43
42 60
00000010000111001000011000001000000000100101010000001100010000101000000100000010001100001000001011000
00101001000100101010010010010000000110000010111011010001101011001000010000000011000100100001000000110
00000100001000001001010000000100100100011000001000101000001001001001000001000001000000010101001000110
11010000000000100100010101001010010011011000001100000000111010001100000000100000010100000000000000000
00001100110000000010011000011000000000000000101110110011000000001000000010100000011001000001100000000
01000100001001001011110000110100100001001001110001101110101110000000000100100001010010000010010110010
11000000001011000011010111100000000101010010000000110001010101110000000010001010010010100100100000101
00000101100000000001001000000001000000000000110000100000101001000001001010100101011110011000001100100
00100001000001001001010000010000010001011000000001111010010100000000110010000101110010010000110110100
11000101111100110000100010101000100010011100000000000011001011000001000000001000001010100100110001001
10011001110000010000001010000000000000010100100001001001010001101000000000000010100100000001010000011
10010000000001100000000000000011000101010000000001110000101110101111000010000001100101000001001000100
00010001000010010011100101000100011000000101001010100000101010000000110110000000001101000001100000100
10110001000010011011000000000000000000010001000010000001001001101010000100000101101110100110000000000
00000000101001110001000000010011100110000001011110100010000000000110000010001001100000100000001010001
00010100001110000101010000010101001100000010000000000000100101001000010010000000111010000010110000000
01000010000100000010101110001010100000000100000110100100011101011001111000110000100000010000100000111
00011001001011100000011000110000100000101101100010100000000100000010000100110100100000100001110011000
00100100010110000000000010000100000011001100000001100101001010000010010001100100000000000110000010000
11010001001000000011110010000001011000001100100001000000010011011000101000010000011000000011010010100
00001000100010001111001100000000010010110011001101000101000100100010110000010001000010000001000100000
11100000000000000000000100010010011011011101000010000100000001000110000001000000100000000000010010010
00100000000000100000100100100010010001100001101100100111011010111001011001100010001010010101000010010
00001000100000101000000001110100011101110001110010010110000001110000011010100010010001101010000000001
10000001001001100010011001000100101010000001000100010001011000000001000011000000001001010010000101001
00010100000000100001101000000010010100000000000000100010100010111000001001010001001010100100001100110
10010000010000000010101000000000010110000001101000100100101101000000001100000001000000100010000001011
11001010010100111100001000000010000000010000000000100111100000101001111000010001001000011110101000100
00101101001001011010000100011111100001110010010100000110000000000001010110000100100000000001010101001
10100000010000011000000001001100001101010010000000011100010001011011100000110100010000010001000101000
10100000111110001010000110011100001001100000000000010000001001000010000100000101110100000010101010010
01110001000100000011001010110000100101010000010011101000000010000000000000100011010110000010010001010
10000000001000001010000100010100001000100000000100110000000001100001001010010011000100000000100010110
01000000000000000111000001001010101100001110001000001001101000100010000010100000100101011011100010000
00010000011001101000100001100000100100001001000010101001110111001000100100100001011110101111010010100
10101000011000000100000010000011101001000001010100000010000100000000100000000001010000011000011010000
00000011100000010001000000010000110000011000100010001011010100000010010000000100100001010100000100000
00010010010100100101000000100001001010000001000100000000001000000111000101100000001000000110010100001
00010001000000001010101100010101010001110010001001001000100010010000000001000101110101000001011010110
10000000000011000001111000000010100100010011001001010010000010001000100001000100010010001100000001000
01001010000000111001011000100010100100100110000000100011000000010100101001010000000100011000000100001
10000110110110111100001111010000001000101000000101011000010001000000010100101100000100000011000000010
01001001011001000101100110000000010000100111110000100000110001010000100000010000000000010101000000001
00000001011001101000000011100000111010100010010100010011001000000001000110010100110000000011000000010
10110100111000001100010000010000000001101000101000000001001000000001101010100000011100001110001010000
00000010000100100010000001000000000000010000010110000000001101010010011010000000000101000000000001100
10001101010000000000000001000111100110110010010000000011001000111000000011011000000010100000110010000
00100010110010100010010001000110000000101000000011001011001001000100000001000101001011000100000111000
11010000010011000000110101000000111100000001000010000010000100001101000010100010000000000100010001011
00100000000010100001110000111000000000110011010010000000101000100001110010100110000101101000000001000
10100001111011001000001000000100110001000000000000100001100000001001000000101000000110010100101000110
10010000101000001000000000000100001100011110101111010010010001010100001100010010100100100001001011111
00010101100000001001000110001100000100001000100000001101011011011000100001010001000110001101000010000
10011100100011010001000000001010010010010010100001000010000000001000000010000010001000000100000000010
00100000001000000000011000001010111000010000100100000001001110010010111000100110010000000010110011011
01100110101100001100101000100100000000001000001000010010001101101001000000100100001100101000001001101
00010101000010100011000010110100010000011000100110010110000011000101010010100000010010001001100000110
01000000100100100011000000010110010000111110011000001000100001111000000010000001110000000110010111100
01000100001011000001111010010110000010000110000001000100001011001000000000110010000001000100000100010
00100100010000000010010011000010110010000000010100010001100110110000000100000000000110010111011001011
10001010001100010110000000000111001011000001001101000110110000010010100110100000010100000011011000100
01010001010000100010001010000000100000100010010000101000001000000111010000000000000000000010001000100
00100100000100000000101100101011100100000101000100000010010101110100011101000010000100000110001000100
00011011001000000001001000100100011100001100000010000000010000001010000001000101100001001000100100101
01000001100100100111001101100000001000000010010000101000000010000000011001100101011000000101110101010
10100100110100001000000110111000000000000000100000001000001010000010001000001000110000001111000001011
01000000110000010001100101000101100000001000010001010000000110000000000100000001000000100001001010000
10011010000000101000000100000000001000010001000000000000010000001000110100001010001010000001000011100
00100001110001001011100000000010000100001000011101000000010100011000010000100001001100001010100001010
01011000011001010100010100101000001000001000001000000001000100000001100000000100000000101000000010000
01000000001000101001000100000001010100100100000011101100000101000000000000111010011110000000000100100
00000100011001000010011000010000001001010100100100001000000011010000000101110100011100100001000101100
01010001010001000010100011011100100000110000000100010011101011000000010010010001000101000010111000101
11010011011011011001000000000110001101010000100000000000011011000101101000000000010000101000000100010
10100001010000000000000100000101000000000110000100100101001011110110111010101000101000000110000001100
00001001000110101000000111000000100000001000000001001101000100110000000100001001000001100001000000111
01001000110010100001011000000010001100101100010001000010000001010000011010000000100000110000000100000
00001111010101001010010110101000101000010010010110110000000111000011010010001010001010111010000100010
00110101101010000001000101010000010001000101000100001110110100000010111001010000011000100010100010100
01000011010010000110101100001001001000100000000001011100000100001000000010100000001000000000000001000
10000000110100001011000000001110010100010000001010010000010001011000000000000001000000001001000110110
00011001100100000000100000001101000000000000000001100010000110111000010001000000000000010001000010101
00011000000101000110110000100101000001000111000000100000100110100000000000000100000001101010100001000
01000010000001001100000001100101100000000001100001000001100000110001110001001000000001011011010101000
00110000000101010100010101100011011101110000000000010100000100001011100100010000000001010110010011110
10100100100000101100001001000000010101000000000001111010001000100110001000000010110000000011001010010
10100100000000010011000100000010001000110100110011000000000100010000000000100000001010000100000001001
00000000000011001100100110101001010110010001011010000001010000100011000101100101100100100100010101001
00011001110000110001111001101000001100010100000110000011000000000000001000100000010100101001000000010
11000001000000000010010010001000100110000011000000001110000000011000000001001000010000011010010010010
00111101000000000000011100001001000000011111110100000000100101101000110000011111000000101110010110011
01001000100000010000100001101000110111010000000101010001101001001001000000010000101000001101111000000
00000000000010100001000000110001000110101110011001000001110101011000100100000010011011100000001100000
10100111100110101010010000000100000100101010110000010010001001100000001011010011000110000011011100001
01100100000100000110001000000110010000011011000010010001101001111000100100010000000011100000000001101
00011011010001001010110100010000001100001001100000100000100110010010100010001000000100100010001010001
10001100010000000010001100001110000100010100000100110110111010010000010100000001100000100110010000100
01000010000001001000000001001000101000110101001000000100000011010001010010101000000000100100001000101
00111000010010001000100100100101011001001010011010000011111001000100000111101111100101000000000110100
00001100100000001100111001001010101100000110100101000100000010000100000001010000010001101001001010010
01000010000001000000100000010000100110100010010001010010010010111001100110100000101100101110001100000
